AA	AA
AE	AE
AH	AH
AO	AO
AW	AW
AY	AY
B	B
CH	CH
D	D
EH	EH
ER	ER
EY	EY
F	F
G	G
HH	HH
IH	IH
IY	IY
JH	JH
K	K
L	L
M	M
N	N
OW	OW
P	P
R	R
S	S
SIL	SIL
T	T
TH	TH
UW	UW
V	V
W	W
Y	Y
Z	Z
