!EXCLAMATION-POINT	EH K S K L AH M EY SH AH N P OY N T
"DOUBLE-QUOTE	D AH B AH L K W OW T
%PERCENT	P ER S EH N T
&AMPERSAND	AE M P ER S AE N D
'SINGLE-QUOTE	S IH NG G AH L K W OW T
(LEFT-PAREN	L EH F T P EH R AH N
)RIGHT-PAREN	R AY T P EH R AH N
,COMMA	K AA M AH
--DASH	D AE SH
-HYPHEN	HH AY F AH N
...ELLIPSIS	EH L IH P S IH S
.PERIOD	P IH R IY AH D
.POINT	P OY N T
/SLASH	S L AE SH
:COLON	K OW L AH N
;SEMI-COLON	S EH M AH K OW L AH N
;SEMI-COLON(2)	S EH M IY K OW L AH N
?QUESTION-MARK	K W EH S CH AH N M AA R K
A	AH
A(2)	EY
A.	EY
A.'S	EY Z
ABANDONED	AH B AE N D AH N D
ABILITY	AH B IH L AH T IY
ABLE	EY B AH L
ABORTION	AH B AO R SH AH N
ABOUT	AH B AW T
ABOVE	AH B AH V
ABROAD	AH B R AO D
ABSENCE	AE B S AH N S
ABSOLUTELY	AE B S AH L UW T L IY
ABUSE	AH B Y UW S
ABUSE(2)	AH B Y UW Z
ABUSES	AH B Y UW S IH Z
ABUSES(2)	AH B Y UW Z IH Z
ACADEMIC	AE K AH D EH M IH K
ACCEPT	AE K S EH P T
ACCEPT(2)	AH K S EH P T
ACCEPTABLE	AE K S EH P T AH B AH L
ACCEPTABLE(2)	AH K S EH P T AH B AH L
ACCEPTANCE	AE K S EH P T AH N S
ACCEPTANCE(2)	AH K S EH P T AH N S
ACCEPTED	AE K S EH P T IH D
ACCEPTED(2)	AH K S EH P T AH D
ACCEPTING	AE K S EH P T IH NG
ACCEPTING(2)	AH K S EH P T IH NG
ACCESS	AE K S EH S
ACCIDENT	AE K S AH D AH N T
ACCORD	AH K AO R D
ACCORDING	AH K AO R D IH NG
ACCOUNT	AH K AW N T
ACCOUNTANTS	AH K AW N T AH N T S
ACCOUNTED	AH K AW N AH D
ACCOUNTED(2)	AH K AW N T AH D
ACCOUNTING	AH K AW N IH NG
ACCOUNTING(2)	AH K AW N T IH NG
ACCOUNTS	AH K AW N T S
ACCURATE	AE K Y ER AH T
ACCUSED	AH K Y UW Z D
ACHIEVE	AH CH IY V
ACHIEVED	AH CH IY V D
ACKNOWLEDGED	AE K N AA L IH JH D
ACKNOWLEDGED(2)	IH K N AA L IH JH D
ACKNOWLEDGES	AE K N AA L IH JH IH Z
ACKNOWLEDGES(2)	IH K N AA L IH JH IH Z
ACQUIRE	AH K W AY ER
ACQUIRED	AH K W AY ER D
ACQUIRING	AH K W AY ER IH NG
ACQUIRING(2)	AH K W AY R IH NG
ACQUISITION	AE K W AH Z IH SH AH N
ACQUISITIONS	AE K W AH Z IH SH AH N Z
ACRE	EY K ER
ACRES	EY K ER Z
ACROSS	AH K R AO S
ACT	AE K T
ACTED	AE K T AH D
ACTED(2)	AE K T IH D
ACTING	AE K T IH NG
ACTION	AE K SH AH N
ACTIONS	AE K SH AH N Z
ACTIVE	AE K T IH V
ACTIVELY	AE K T IH V L IY
ACTIVISTS	AE K T AH V AH S
ACTIVISTS(2)	AE K T AH V AH S S
ACTIVISTS(3)	AE K T AH V AH S T S
ACTIVISTS(4)	AE K T IH V IH S
ACTIVISTS(5)	AE K T IH V IH S S
ACTIVISTS(6)	AE K T IH V IH S T S
ACTIVITIES	AE K T IH V AH T IY Z
ACTIVITIES(2)	AE K T IH V IH T IY Z
ACTIVITY	AE K T IH V AH T IY
ACTIVITY(2)	AE K T IH V IH T IY
ACTS	AE K S
ACTS(2)	AE K T S
ACTUAL	AE K CH AH W AH L
ACTUAL(2)	AE K SH AH L
ACTUALLY	AE K CH AH W AH L IY
ACTUALLY(2)	AE K CH L IY
ACTUALLY(3)	AE K SH AH L IY
ACTUALLY(4)	AE K SH L IY
AD	AE D
ADAMS	AE D AH M Z
ADD	AE D
ADDED	AE D AH D
ADDED(2)	AE D IH D
ADDING	AE D IH NG
ADDITION	AH D IH SH AH N
ADDITIONAL	AH D IH SH AH N AH L
ADDITIONAL(2)	AH D IH SH N AH L
ADDRESS	AE D R EH S
ADDRESS(2)	AH D R EH S
ADDS	AE D Z
ADEQUATE	AE D AH K W AH T
ADEQUATE(2)	AE D AH K W EY T
ADJUSTABLE	AH JH AH S T AH B AH L
ADJUSTED	AH JH AH S T AH D
ADJUSTED(2)	AH JH AH S T IH D
ADJUSTMENT	AH JH AH S T M AH N T
ADJUSTMENTS	AH JH AH S T M AH N T S
ADMINISTRATION	AE D M IH N IH S T R EY SH AH N
ADMINISTRATION'S	AE D M IH N IH S T R EY SH AH N Z
ADMINISTRATIVE	AH D M IH N AH S T R EY T IH V
ADMINISTRATOR	AH D M IH N AH S T R EY T ER
ADMIRAL	AE D M ER AH L
ADMIT	AH D M IH T
ADMITS	AH D M IH T S
ADMITTED	AH D M IH T AH D
ADOPT	AH D AA P T
ADOPTED	AH D AA P T AH D
ADS	AE D Z
ADULTS	AE D AH L T S
ADULTS(2)	AH D AH L T S
ADVANCE	AH D V AE N S
ADVANCED	AH D V AE N S T
ADVANCES	AH D V AE N S AH Z
ADVANCES(2)	AH D V AE N S IH Z
ADVANCING	AH D V AE N S IH NG
ADVANTAGE	AE D V AE N IH JH
ADVANTAGE(2)	AE D V AE N T IH JH
ADVANTAGE(3)	AH D V AE N AH JH
ADVANTAGE(4)	AH D V AE N T IH JH
ADVANTAGES	AE D V AE N IH JH IH Z
ADVANTAGES(2)	AE D V AE N T IH JH IH Z
ADVANTAGES(3)	AH D V AE N IH JH IH Z
ADVANTAGES(4)	AH D V AE N T IH JH IH Z
ADVERTISERS	AE D V ER T AY Z ER Z
ADVERTISING	AE D V ER T AY Z IH NG
ADVICE	AE D V AY S
ADVICE(2)	AH D V AY S
ADVISED	AE D V AY Z D
ADVISED(2)	AH D V AY Z D
ADVISER	AE D V AY Z ER
ADVISERS	AE D V AY Z ER Z
ADVISORY	AE D V AY Z ER IY
ADVISORY(2)	AH D V AY Z ER IY
ADVOCATES	AE D V AH K AH T S
ADVOCATES(2)	AE D V AH K EY T S
AEROSPACE	EH R OW S P EY S
AFFAIR	AH F EH R
AFFAIRS	AH F EH R Z
AFFECT	AH F EH K T
AFFECTED	AH F EH K T AH D
AFFECTED(2)	AH F EH K T IH D
AFFECTING	AH F EH K T IH NG
AFFILIATE	AH F IH L IY AH T
AFFILIATE(2)	AH F IH L IY EY T
AFFILIATED	AH F IH L IY EY T AH D
AFFILIATED(2)	AH F IH L IY EY T IH D
AFFILIATES	AH F IH L IY AH T S
AFFILIATES(2)	AH F IH L IY EY T S
AFFORD	AH F AO R D
AFGHAN	AE F G AE N
AFGHANISTAN	AE F G AE N AH S T AE N
AFRAID	AH F R EY D
AFRICA	AE F ER K AH
AFRICA(2)	AE F R AH K AH
AFRICA(3)	AE F R IH K AH
AFRICAN	AE F R AH K AH N
AFRICAN(2)	AE F R IH K AH N
AFTER	AE F T ER
AFTERNOON	AE F T ER N UW N
AGAIN	AH G EH N
AGAIN(2)	AH G EY N
AGAINST	AH G EH N S T
AGE	EY JH
AGENCIES	EY JH AH N S IY Z
AGENCY	EY JH AH N S IY
AGENCY'S	EY JH AH N S IY Z
AGENDA	AH JH EH N D AH
AGENT	EY JH AH N T
AGENTS	EY JH AH N T S
AGGRESSIVE	AH G R EH S IH V
AGGRESSIVELY	AH G R EH S IH V L IY
AGING	EY JH IH NG
AGO	AH G OW
AGREE	AH G R IY
AGREED	AH G R IY D
AGREEING	AH G R IY IH NG
AGREEMENT	AH G R IY M AH N T
AGREEMENTS	AH G R IY M AH N T S
AGREES	AH G R IY Z
AGRICULTURAL	AE G R AH K AH L CH ER AH L
AGRICULTURAL(2)	AE G R IH K AH L CH ER AH L
AGRICULTURE	AE G R IH K AH L CH ER
AHEAD	AH HH EH D
AID	EY D
AIDE	EY D
AIDED	EY D AH D
AIDED(2)	EY D IH D
AIDES	EY D Z
AIDS	EY D Z
AILING	EY L IH NG
AIM	EY M
AIMED	EY M D
AIR	EH R
AIRBUS	EH R B AH S
AIRCRAFT	EH R K R AE F T
AIRLINE	EH R L AY N
AIRLINES	EH R L AY N Z
AIRPORT	EH R P AO R T
AIRPORTS	EH R P AO R T S
AIRWAYS	EH R W EY Z
AL	AE L
ALABAMA	AE L AH B AE M AH
ALAN	AE L AH N
ALASKA	AH L AE S K AH
ALBERT	AE L B ER T
ALBERTA	AE L B ER T AH
ALCOHOL	AE L K AH HH AA L
ALEXANDER	AE L AH G Z AE N D ER
ALEXANDER(2)	AE L IH G Z AE N D ER
ALIVE	AH L AY V
ALL	AO L
ALLEGATIONS	AE L AH G EY SH AH N Z
ALLEGED	AH L EH JH D
ALLEGEDLY	AH L EH JH AH D L IY
ALLEGES	AH L EH JH AH Z
ALLEGES(2)	AH L EH JH IH Z
ALLEGHENY	AE L AH G EY N IY
ALLEGING	AH L EH JH IH NG
ALLEGIS	AE L EY JH IH S
ALLEN	AE L AH N
ALLIANCE	AH L AY AH N S
ALLIED	AE L AY D
ALLIED(2)	AH L AY D
ALLIES	AE L AY Z
ALLIES(2)	AH L AY Z
ALLOW	AH L AW
ALLOWED	AH L AW D
ALLOWING	AH L AW IH NG
ALLOWS	AH L AW Z
ALMOST	AO L M OW S T
ALONE	AH L OW N
ALONG	AH L AO NG
ALREADY	AO L R EH D IY
ALREADY(2)	AO R EH D IY
ALSO	AO L S OW
ALTER	AO L T ER
ALTERNATIVE	AO L T ER N AH T IH V
ALTERNATIVES	AO L T ER N AH T IH V Z
ALTHOUGH	AO L DH OW
ALUMINUM	AH L UW M AH N AH M
ALWAYS	AO L W EY Z
ALWAYS(2)	AO L W IY Z
AM	AE M
AM(2)	EY EH M
AMBASSADOR	AE M B AE S AH D ER
AMBITIOUS	AE M B IH SH AH S
AMENDED	AH M EH N D AH D
AMENDED(2)	AH M EH N D IH D
AMENDMENT	AH M EH N D M AH N T
AMENDMENTS	AH M EH N D M AH N T S
AMERICA	AH M EH R AH K AH
AMERICA(2)	AH M EH R IH K AH
AMERICA'S	AH M EH R AH K AH Z
AMERICA'S(2)	AH M EH R IH K AH Z
AMERICAN	AH M EH R AH K AH N
AMERICAN(2)	AH M EH R IH K AH N
AMERICANS	AH M EH R AH K AH N Z
AMERICANS(2)	AH M EH R IH K AH N Z
AMID	AH M IH D
AMOCO	AE M AH K OW
AMONG	AH M AH NG
AMOUNT	AH M AW N T
AMOUNTS	AH M AW N T S
AN	AE N
AN(2)	AH N
ANALYSIS	AH N AE L AH S AH S
ANALYSIS(2)	AH N AE L IH S IH S
ANALYST	AE N AH L AH S T
ANALYST(2)	AE N AH L IH S T
ANALYSTS	AE N AH L AH S
ANALYSTS(2)	AE N AH L AH S S
ANALYSTS(3)	AE N AH L AH S T S
ANALYSTS(4)	AE N AH L IH S
ANALYSTS(5)	AE N AH L IH S S
ANALYSTS(6)	AE N AH L IH S T S
ANALYSTS'	AE N AH L IH S
ANALYSTS'(2)	AE N AH L IH S S
ANALYSTS'(3)	AE N AH L IH S T S
AND	AE N D
AND(2)	AH N D
ANDERSON	AE N D ER S AH N
ANDREW	AE N D R UW
ANGELES	AE N JH AH L IH S
ANGRY	AE NG G R IY
ANIMAL	AE N AH M AH L
ANIMALS	AE N AH M AH L Z
ANNOUNCE	AH N AW N S
ANNOUNCED	AH N AW N S T
ANNOUNCEMENT	AH N AW N S M AH N T
ANNOUNCEMENT(2)	AH N AW N S M EH N T
ANNOUNCING	AH N AW N S IH NG
ANNUAL	AE N Y UW AH L
ANNUALLY	AE N Y UW AH L IY
ANOTHER	AH N AH DH ER
ANSWER	AE N S ER
ANSWERS	AE N S ER Z
ANTHONY	AE N TH AH N IY
ANTI	AE N T AY
ANTI(2)	AE N T IY
ANTICIPATED	AE N T IH S AH P EY T AH D
ANTICIPATED(2)	AE N T IH S AH P EY T IH D
ANTICIPATION	AE N T IH S AH P EY SH AH N
ANTITRUST	AE N T AY T R AH S T
ANTONIO	AE N T OW N IY OW
ANY	EH N IY
ANYBODY	EH N IY B AH D IY
ANYMORE	EH N IY M AO R
ANYONE	EH N IY W AH N
ANYTHING	EH N IY TH IH NG
ANYWAY	EH N IY W EY
ANYWHERE	EH N IY HH W EH R
ANYWHERE(2)	EH N IY W EH R
APART	AH P AA R T
APARTHEID	AH P AA R T AY D
APARTHEID(2)	AH P AA R T AY T
APARTMENT	AH P AA R T M AH N T
APPAREL	AH P AE R AH L
APPAREL(2)	AH P EH R AH L
APPARENT	AH P EH R AH N T
APPARENTLY	AH P EH R AH N T L IY
APPEAL	AH P IY L
APPEALED	AH P IY L D
APPEALS	AH P IY L Z
APPEAR	AH P IH R
APPEARANCE	AH P IH R AH N S
APPEARED	AH P IH R D
APPEARS	AH P IH R Z
APPLE	AE P AH L
APPLICATION	AE P L AH K EY SH AH N
APPLICATIONS	AE P L AH K EY SH AH N Z
APPLIED	AH P L AY D
APPLY	AH P L AY
APPOINTED	AH P OY N T AH D
APPOINTED(2)	AH P OY N T IH D
APPOINTMENT	AH P OY N T M AH N T
APPRECIATION	AH P R IY SH IY EY SH AH N
APPROACH	AH P R OW CH
APPROACHED	AH P R OW CH T
APPROPRIATE	AH P R OW P R IY AH T
APPROPRIATE(2)	AH P R OW P R IY EY T
APPROPRIATIONS	AH P R OW P R IY EY SH AH N Z
APPROVAL	AH P R UW V AH L
APPROVE	AH P R UW V
APPROVED	AH P R UW V D
APPROXIMATELY	AH P R AA K S AH M AH T L IY
APRIL	EY P R AH L
AQUINO	AH K IY N OW
ARAB	AE R AH B
ARAB(2)	EH R AH B
ARABIA	ER EY B IY AH
ARBITRAGE	AA R B IH T R AA ZH
ARBITRAGERS	AA R B IH T R AA ZH ER Z
ARBITRATION	AA R B IH T R EY SH AH N
ARE	AA R
ARE(2)	ER
AREA	EH R IY AH
AREAS	EH R IY AH Z
AREN'T	AA R AH N T
AREN'T(2)	AA R N T
ARGENTINA	AA R JH AH N T IY N AH
ARGUE	AA R G Y UW
ARGUED	AA R G Y UW D
ARGUES	AA R G Y UW Z
ARGUING	AA R G Y UW IH NG
ARGUMENT	AA R G Y AH M AH N T
ARGUMENTS	AA R G Y AH M AH N T S
ARIZONA	EH R IH Z OW N AH
ARKANSAS	AA R K AH N S AA
ARM	AA R M
ARMED	AA R M D
ARMS	AA R M Z
ARMY	AA R M IY
ARNOLD	AA R N AH L D
AROUND	ER AW N
AROUND(2)	ER AW N D
ARRANGE	ER EY N JH
ARRANGED	ER EY N JH D
ARRANGEMENT	ER EY N JH M AH N T
ARRANGEMENTS	ER EY N JH M AH N T S
ARREST	ER EH S T
ARRESTED	ER EH S T AH D
ARRESTED(2)	ER EH S T IH D
ARRIVED	ER AY V D
ART	AA R T
ARTHUR	AA R TH ER
ARTICLE	AA R T AH K AH L
ARTICLE(2)	AA R T IH K AH L
ARTICLES	AA R T AH K AH L Z
ARTICLES(2)	AA R T IH K AH L Z
ARTIST	AA R T AH S T
ARTIST(2)	AA R T IH S T
ARTISTS	AA R T AH S T S
ARTISTS(2)	AA R T IH S
ARTISTS(3)	AA R T IH S S
ARTISTS(4)	AA R T IH S T S
ARTS	AA R T S
AS	AE Z
AS(2)	EH Z
ASBESTOS	AE S B EH S T AH S
ASIA	EY ZH AH
ASIAN	EY ZH AH N
ASIDE	AH S AY D
ASK	AE S K
ASKED	AE S K T
ASKED(2)	AO S K T
ASKING	AE S K IH NG
ASKS	AE S K S
ASPECTS	AE S P EH K T S
ASSEMBLY	AH S EH M B L IY
ASSERTED	AH S ER T AH D
ASSERTS	AH S ER T S
ASSESSMENT	AH S EH S M AH N T
ASSET	AE S EH T
ASSETS	AE S EH T S
ASSIGNED	AH S AY N D
ASSISTANCE	AH S IH S T AH N S
ASSISTANT	AH S IH S T AH N T
ASSOCIATE	AH S OW S IY AH T
ASSOCIATE(2)	AH S OW S IY EY T
ASSOCIATE(3)	AH S OW SH IY AH T
ASSOCIATE(4)	AH S OW SH IY EY T
ASSOCIATED	AH S OW S IY EY T AH D
ASSOCIATED(2)	AH S OW SH IY EY T AH D
ASSOCIATES	AH S OW S IY AH T S
ASSOCIATES(2)	AH S OW S IY EY T S
ASSOCIATES(3)	AH S OW SH IY AH T S
ASSOCIATES(4)	AH S OW SH IY EY T S
ASSOCIATION	AH S OW S IY EY SH AH N
ASSOCIATION(2)	AH S OW SH IY EY SH AH N
ASSUME	AH S UW M
ASSUMED	AH S UW M D
ASSUMING	AH S UW M IH NG
ASSUMPTION	AH S AH M P SH AH N
ASSURANCE	AH SH UH R AH N S
ASSURED	AH SH UH R D
AT	AE T
ATLANTA	AE T L AE N AH
ATLANTA(2)	AE T L AE N T AH
ATLANTA(3)	AH T L AE N AH
ATLANTA(4)	AH T L AE N T AH
ATLANTIC	AH T L AE N IH K
ATLANTIC(2)	AH T L AE N T IH K
ATMOSPHERE	AE T M AH S F IH R
ATTACK	AH T AE K
ATTACKED	AH T AE K T
ATTACKS	AH T AE K S
ATTEMPT	AH T EH M P T
ATTEMPTED	AH T EH M P T AH D
ATTEMPTING	AH T EH M P T IH NG
ATTEMPTS	AH T EH M P S
ATTEMPTS(2)	AH T EH M P T S
ATTEND	AH T EH N D
ATTENDANTS	AH T EH N D AH N T S
ATTENDED	AH T EH N D AH D
ATTENTION	AH T EH N SH AH N
ATTITUDE	AE T AH T UW D
ATTORNEY	AH T ER N IY
ATTORNEYS	AH T ER N IY Z
ATTRACT	AH T R AE K T
ATTRACTED	AH T R AE K T AH D
ATTRACTIVE	AH T R AE K T IH V
ATTRIBUTED	AH T R IH B Y AH T AH D
AUCTION	AA K SH AH N
AUCTION(2)	AO K SH AH N
AUDIENCE	AA D IY AH N S
AUDIENCE(2)	AO D IY AH N S
AUDIT	AO D IH T
AUDITORS	AA D AH T ER Z
AUGUST	AA G AH S T
AUGUST(2)	AO G AH S T
AUSTIN	AO S T AH N
AUSTRALIA	AO S T R EY L Y AH
AUSTRALIAN	AO S T R EY L Y AH N
AUTHOR	AO TH ER
AUTHORITIES	AH TH AO R AH T IY Z
AUTHORITY	AH TH AO R AH T IY
AUTHORIZED	AO TH ER AY Z D
AUTO	AO T OW
AUTOMATED	AO T AH M EY T IH D
AUTOMATIC	AO T AH M AE T IH K
AUTOMATIC(2)	AO T OW M AE T IH K
AUTOMATICALLY	AO T AH M AE T IH K L IY
AUTOMATICALLY(2)	AO T OW M AE T IH K L IY
AUTOMOBILE	AO T AH M OW B IY L
AUTOMOTIVE	AO T AH M OW T IH V
AVAILABLE	AH V EY L AH B AH L
AVENUE	AE V AH N UW
AVERAGE	AE V ER IH JH
AVERAGE(2)	AE V R AH JH
AVERAGE(3)	AE V R IH JH
AVERAGED	AE V R AH JH D
AVERAGED(2)	AE V R IH JH D
AVIATION	EY V IY EY SH AH N
AVOID	AH V OY D
AVOIDED	AH V OY D AH D
AVOIDED(2)	AH V OY D IH D
AWARD	AH W AO R D
AWARDED	AH W AO R D AH D
AWARDED(2)	AH W AO R D IH D
AWARDS	AH W AO R D Z
AWARE	AH W EH R
AWAY	AH W EY
B.	B IY
BABY	B EY B IY
BACHE	B AE CH
BACHE(2)	B EY CH
BACK	B AE K
BACKED	B AE K T
BACKGROUND	B AE K G R AW N D
BACKING	B AE K IH NG
BAD	B AE D
BADLY	B AE D L IY
BAGS	B AE G Z
BAILOUT	B EY L AW T
BAKER	B EY K ER
BALANCE	B AE L AH N S
BALANCED	B AE L AH N S T
BALL	B AO L
BALTIMORE	B AO L T AH M AO R
BAN	B AE N
BANCORP	B AE N K AO R P
BANCORP(2)	B AE NG K AO R P
BAND	B AE N D
BANK	B AE NG K
BANK'S	B AE NG K S
BANKAMERICA	B AE NG K AH M EH R IH K AH
BANKER	B AE NG K ER
BANKERS	B AE NG K ER Z
BANKING	B AE NG K IH NG
BANKRUPTCY	B AE NG K R AH P S IY
BANKRUPTCY(2)	B AE NG K R AH P T S IY
BANKS	B AE NG K S
BANKS'	B AE NG K S
BANNED	B AE N D
BAR	B AA R
BARBARA	B AA R B ER AH
BARBARA(2)	B AA R B R AH
BARELY	B EH R L IY
BARGAIN	B AA R G AH N
BARGAIN(2)	B AA R G IH N
BARGAINING	B AA R G IH N IH NG
BARNEY	B AA R N IY
BARRED	B AA R D
BARREL	B AE R AH L
BARREL(2)	B EH R AH L
BARRELS	B AE R AH L Z
BARRELS(2)	B EH R AH L Z
BARRIERS	B AE R IY ER Z
BARRIERS(2)	B EH R IY ER Z
BARRING	B AA R IH NG
BARRY	B AE R IY
BARRY(2)	B EH R IY
BARS	B AA R Z
BASE	B EY S
BASEBALL	B EY S B AO L
BASED	B EY S T
BASES	B EY S AH Z
BASES(2)	B EY S IH Z
BASES(3)	B EY S IY Z
BASIC	B EY S IH K
BASICALLY	B EY S IH K L IY
BASIS	B EY S AH S
BASIS(2)	B EY S IH S
BASS	B AE S
BASS(2)	B EY S
BATTLE	B AE T AH L
BATTLES	B AE T AH L Z
BAY	B EY
BE	B IY
BEACH	B IY CH
BEAR	B EH R
BEARING	B EH R IH NG
BEARISH	B EH R IH SH
BEAT	B IY T
BECAME	B IH K EY M
BECAME(2)	B IY K EY M
BECAUSE	B IH K AH Z
BECAUSE(2)	B IH K AO Z
BECOME	B IH K AH M
BECOMES	B IH K AH M Z
BECOMING	B IH K AH M IH NG
BED	B EH D
BEEF	B IY F
BEEN	B AH N
BEEN(2)	B IH N
BEER	B IH R
BEFORE	B IH F AO R
BEFORE(2)	B IY F AO R
BEGAN	B IH G AE N
BEGAN(2)	B IY G AE N
BEGIN	B IH G IH N
BEGINNING	B IH G IH N IH NG
BEGINS	B IH G IH N Z
BEGUN	B EY G AH N
BEGUN(2)	B IH G AH N
BEHALF	B IH HH AE F
BEHAVIOR	B IH HH EY V Y ER
BEHIND	B IH HH AY N D
BEIJING	B EY ZH IH NG
BEING	B IY IH NG
BELGIAN	B EH L JH AH N
BELGIQUE	B EH L ZH IY K
BELIEF	B IH L IY F
BELIEVE	B IH L IY V
BELIEVED	B IH L IY V D
BELIEVES	B IH L IY V Z
BELL	B EH L
BELOW	B IH L OW
BELOW(2)	B IY L OW
BELT	B EH L T
BENCHMARK	B EH N CH M AA R K
BENEDETTI	B EH N AH D EH T IY
BENEFICIAL	B EH N AH F IH SH AH L
BENEFIT	B EH N AH F IH T
BENEFITED	B EH N AH F IH T IH D
BENEFITS	B EH N AH F IH T S
BENNETT	B EH N AH T
BENNETT(2)	B EH N IH T
BENTSEN	B EH N T S AH N
BENZ	B AE N Z
BENZ(2)	B EH N Z
BERLIN	B ER L IH N
BESIDES	B IH S AY D Z
BEST	B EH S T
BET	B EH T
BETTER	B EH T ER
BETTING	B EH T IH NG
BETWEEN	B IH T W IY N
BETWEEN(2)	B IY T W IY N
BEVERLY	B EH V ER L IY
BEYOND	B IH AA N D
BEYOND(2)	B IH AO N D
BEYOND(3)	B IY AO N D
BID	B IH D
BIDDER	B IH D ER
BIDDERS	B IH D ER Z
BIDDING	B IH D IH NG
BIDS	B IH D Z
BIG	B IH G
BIGGER	B IH G ER
BIGGEST	B IH G AH S T
BILL	B IH L
BILLION	B IH L Y AH N
BILLIONS	B IH L Y AH N Z
BILLS	B IH L Z
BIOTECHNOLOGY	B AY OW T EH K N AA L AH JH IY
BIRTH	B ER TH
BIT	B IH T
BITTER	B IH T ER
BLACK	B L AE K
BLACKS	B L AE K S
BLAME	B L EY M
BLAMED	B L EY M D
BLOC	B L AA K
BLOCK	B L AA K
BLOCKED	B L AA K T
BLOCKS	B L AA K S
BLOOD	B L AH D
BLOW	B L OW
BLUE	B L UW
BOARD	B AO R D
BOARD'S	B AO R D Z
BOARDS	B AO R D Z
BOAT	B OW T
BOB	B AA B
BODY	B AA D IY
BOEING	B OW IH NG
BOESKY	B OW S K IY
BOLSTER	B OW L S T ER
BOMB	B AA M
BOMB(2)	B AO M
BOND	B AA N D
BONDS	B AA N D Z
BONN	B AA N
BONUS	B OW N AH S
BONUSES	B OW N AH S IH Z
BOOK	B UH K
BOOKS	B UH K S
BOOM	B UW M
BOOMING	B UW M IH NG
BOOST	B UW S T
BOOSTED	B UW S T IH D
BOOSTING	B UW S T IH NG
BORDER	B AO R D ER
BORK	B AO R K
BORN	B AO R N
BORROW	B AA R OW
BORROWED	B AA R OW D
BORROWERS	B AA R OW ER Z
BORROWING	B AA R OW IH NG
BORROWINGS	B AA R OW IH NG Z
BOSS	B AA S
BOSS(2)	B AO S
BOSTON	B AA S T AH N
BOSTON(2)	B AO S T AH N
BOTH	B OW TH
BOTTOM	B AA T AH M
BOUGHT	B AA T
BOUGHT(2)	B AO T
BOUND	B AW N D
BOX	B AA K S
BOY	B OY
BOYS	B OY Z
BRADY	B R EY D IY
BRANCH	B R AE N CH
BRANCHES	B R AE N CH AH Z
BRANCHES(2)	B R AE N CH IH Z
BRAND	B R AE N D
BRANDS	B R AE N D Z
BRAZIL	B R AH Z IH L
BRAZIL'S	B R AH Z IH L Z
BRAZILIAN	B R AH Z IH L Y AH N
BREAK	B R EY K
BREAKING	B R EY K IH NG
BREAKS	B R EY K S
BRIAN	B R AY AH N
BRIDGE	B R IH JH
BRIEF	B R IY F
BRIGHT	B R AY T
BRING	B R IH NG
BRINGING	B R IH NG IH NG
BRINGS	B R IH NG Z
BRITAIN	B R IH T AH N
BRITAIN'S	B R IH T AH N Z
BRITISH	B R IH T IH SH
BROAD	B R AO D
BROADCAST	B R AO D K AE S T
BROADCASTING	B R AO D K AE S T IH NG
BROADER	B R AO D ER
BROKE	B R OW K
BROKEN	B R OW K AH N
BROKER	B R OW K ER
BROKERAGE	B R OW K ER IH JH
BROKERAGE(2)	B R OW K R IH JH
BROKERS	B R OW K ER Z
BROTHER	B R AH DH ER
BROTHERS	B R AH DH ER Z
BROUGHT	B R AO T
BROWN	B R AW N
BRUCE	B R UW S
BRUSSELS	B R AH S AH L Z
BUDGET	B AH JH IH T
BUDGETS	B AH JH IH T S
BUILD	B IH L D
BUILDING	B IH L D IH NG
BUILDINGS	B IH L D IH NG Z
BUILT	B IH L T
BULK	B AH L K
BULL	B UH L
BULLISH	B UH L IH SH
BUNDESBANK	B AA N D IH S B AE NG K
BUNDESBANK(2)	B UH N D IH S B AA NG K
BUNDESBANK(3)	B UH N D IH S B AE NG K
BURDEN	B ER D AH N
BUREAU	B Y UH R OW
BUREAUCRACY	B Y UH R AA K R AH S IY
BURGER	B ER G ER
BURLINGTON	B ER L IH NG T AH N
BURNHAM	B ER N AH M
BURNHAM(2)	B ER N HH AE M
BURNS	B ER N Z
BUS	B AH S
BUSH	B UH SH
BUSH'S	B UH SH IH Z
BUSINESS	B IH Z N AH S
BUSINESS(2)	B IH Z N IH S
BUSINESSES	B IH Z N AH S AH Z
BUSINESSES(2)	B IH Z N IH S IH Z
BUSINESSMAN	B IH Z N AH S M AE N
BUSINESSMAN(2)	B IH Z N IH S M AE N
BUSINESSMEN	B IH Z N IH S M EH N
BUSY	B IH Z IY
BUT	B AH T
BUY	B AY
BUYER	B AY ER
BUYERS	B AY ER Z
BUYING	B AY IH NG
BUYOUT	B AY AW T
BUYS	B AY Z
BY	B AY
C.	S IY
C.'S	S IY Z
CABINET	K AE B AH N AH T
CABINET(2)	K AE B N AH T
CABLE	K EY B AH L
CALCULATED	K AE L K Y AH L EY T AH D
CALCULATED(2)	K AE L K Y AH L EY T IH D
CALIFORNIA	K AE L AH F AO R N Y AH
CALL	K AO L
CALLED	K AO L D
CALLING	K AO L IH NG
CALLS	K AO L Z
CAMBRIDGE	K EY M B R IH JH
CAME	K EY M
CAMERA	K AE M ER AH
CAMERA(2)	K AE M R AH
CAMP	K AE M P
CAMPAIGN	K AE M P EY N
CAMPAIGNS	K AE M P EY N Z
CAMPBELL	K AE M B AH L
CAMPEAU	K AE M P OW
CAN	K AE N
CAN(2)	K AH N
CAN'T	K AE N T
CANADA	K AE N AH D AH
CANADA'S	K AE N AH D AH Z
CANADIAN	K AH N EY D IY AH N
CANCELED	K AE N S AH L D
CANCER	K AE N S ER
CANDIDATE	K AE N AH D IH T
CANDIDATE(2)	K AE N D AH D EY T
CANDIDATES	K AE N AH D IH T S
CANDIDATES(2)	K AE N D AH D EY T S
CANNOT	K AE N AA T
CANNOT(2)	K AH N AA T
CAP	K AE P
CAPABLE	K EY P AH B AH L
CAPACITY	K AH P AE S AH T IY
CAPACITY(2)	K AH P AE S IH T IY
CAPITAL	K AE P AH T AH L
CAPITAL(2)	K AE P IH T AH L
CAPITALIZATION	K AE P IH T AH L IH Z EY SH AH N
CAPITOL	K AE P IH T AH L
CAR	K AA R
CARBIDE	K AA R B AY D
CARD	K AA R D
CARDS	K AA R D Z
CARE	K EH R
CAREER	K ER IH R
CAREFUL	K EH R F AH L
CAREFULLY	K EH R F AH L IY
CARGO	K AA R G OW
CARL	K AA R L
CAROLINA	K EH R AH L AY N AH
CARRIED	K AE R IY D
CARRIED(2)	K EH R IY D
CARRIER	K AE R IY ER
CARRIER(2)	K EH R IY ER
CARRIERS	K AE R IY ER Z
CARRIERS(2)	K EH R IY ER Z
CARRIES	K AE R IY Z
CARRIES(2)	K EH R IY Z
CARRY	K AE R IY
CARRY(2)	K EH R IY
CARRYING	K AE R IY IH NG
CARRYING(2)	K EH R IY IH NG
CARS	K AA R Z
CARS(2)	K AA Z
CARTER	K AA R T ER
CASE	K EY S
CASES	K EY S AH Z
CASES(2)	K EY S IH Z
CASEY	K EY S IY
CASH	K AE SH
CASINO	K AH S IY N OW
CAST	K AE S T
CASUALTY	K AE ZH AH L T IY
CASUALTY(2)	K AE ZH AH W AH L T IY
CASUALTY(3)	K AE ZH W AH L T IY
CATALOG	K AE T AH L AO G
CATCH	K AE CH
CATEGORIES	K AE T AH G AO R IY Z
CATEGORY	K AE T AH G AO R IY
CATHOLIC	K AE TH L IH K
CATTLE	K AE T AH L
CAUGHT	K AA T
CAUGHT(2)	K AO T
CAUSE	K AA Z
CAUSE(2)	K AO Z
CAUSED	K AA Z D
CAUSED(2)	K AO Z D
CAUSES	K AA Z AH Z
CAUSES(2)	K AO Z IH Z
CAUSING	K AA Z IH NG
CAUSING(2)	K AO Z IH NG
CAUTION	K AA SH AH N
CAUTION(2)	K AO SH AH N
CAUTIONED	K AA SH AH N D
CAUTIONED(2)	K AO SH AH N D
CAUTIOUS	K AO SH AH S
CEASE	S IY S
CEILING	S IY L IH NG
CELLS	S EH L Z
CELLULAR	S EH L Y AH L ER
CEMENT	S AH M EH N T
CEMENT(2)	S IH M EH N T
CENSUS	S EH N S AH S
CENT	S EH N T
CENTER	S EH N ER
CENTER(2)	S EH N T ER
CENTERS	S EH N ER Z
CENTERS(2)	S EH N T ER Z
CENTRAL	S EH N T R AH L
CENTS	S EH N S
CENTS(2)	S EH N T S
CENTURY	S EH N CH ER IY
CERTAIN	S ER T AH N
CERTAINLY	S ER T AH N L IY
CERTIFICATES	S ER T IH F IH K AH T S
CHAIN	CH EY N
CHAINS	CH EY N Z
CHAIRMAN	CH EH R M AH N
CHALLENGE	CH AE L AH N JH
CHALLENGED	CH AE L AH JH D
CHALLENGES	CH AE L AH N JH IH Z
CHALLENGING	CH AE L AH N JH IH NG
CHAMBER	CH EY M B ER
CHAMPION	CH AE M P IY AH N
CHANCE	CH AE N S
CHANCELLOR	CH AE N S AH L ER
CHANCELLOR(2)	CH AE N S L ER
CHANCES	CH AE N S AH Z
CHANCES(2)	CH AE N S IH Z
CHANGE	CH EY N JH
CHANGED	CH EY N JH D
CHANGES	CH EY N JH AH Z
CHANGES(2)	CH EY N JH IH Z
CHANGING	CH EY N JH IH NG
CHANNEL	CH AE N AH L
CHAPTER	CH AE P T ER
CHARACTER	K EH R IH K T ER
CHARACTERS	K AE R IH K T ER Z
CHARACTERS(2)	K EH R AH K T ER Z
CHARGE	CH AA R JH
CHARGED	CH AA R JH D
CHARGES	CH AA R JH AH Z
CHARGES(2)	CH AA R JH IH Z
CHARGING	CH AA R JH IH NG
CHARLES	CH AA R AH L Z
CHARLES(2)	CH AA R L Z
CHARTER	CH AA R T ER
CHARTERED	CH AA R T ER D
CHASE	CH EY S
CHEAP	CH IY P
CHEAPER	CH IY P ER
CHECK	CH EH K
CHECKS	CH EH K S
CHEMICAL	K EH M AH K AH L
CHEMICAL(2)	K EH M IH K AH L
CHEMICALS	K EH M IH K AH L Z
CHEVRON	SH EH V R AA N
CHEVRON(2)	SH EH V R AH N
CHICAGO	SH AH K AA G OW
CHICKEN	CH IH K AH N
CHIEF	CH IY F
CHILD	CH AY L D
CHILDREN	CH IH L D R AH N
CHILDREN'S	CH IH L D R AH N Z
CHINA	CH AY N AH
CHINA'S	CH AY N AH Z
CHINESE	CH AY N IY Z
CHIP	CH IH P
CHIPS	CH IH P S
CHOICE	CH OY S
CHOICES	CH OY S AH Z
CHOICES(2)	CH OY S IH Z
CHOLESTEROL	K AH L EH S T ER AH L
CHOLESTEROL(2)	K AH L EH S T ER AO L
CHOOSE	CH UW Z
CHOSE	CH OW Z
CHOSEN	CH OW Z AH N
CHRISTIAN	K R IH S CH AH N
CHRISTIAN(2)	K R IH S CH IH N
CHRISTMAS	K R IH S M AH S
CHRISTOPHER	K R IH S T AH F ER
CHRYSLER	K R AY S L ER
CHRYSLER'S	K R AY S L ER Z
CHURCH	CH ER CH
CIGARETTE	S IH G ER EH T
CINCINNATI	S IH N S AH N AE T IY
CIRCLE	S ER K AH L
CIRCUIT	S ER K AH T
CIRCULATION	S ER K Y AH L EY SH AH N
CIRCUMSTANCES	S ER K AH M S T AE N S AH Z
CIRCUMSTANCES(2)	S ER K AH M S T AE N S IH Z
CITED	S AY T AH D
CITED(2)	S AY T IH D
CITIBANK	S IH T IY B AE NG K
CITICORP	S IH T IY K AO R P
CITICORP'S	S IH T IY K AO R P S
CITIES	S IH T IY Z
CITING	S AY T IH NG
CITIZENS	S IH T AH Z AH N Z
CITIZENS(2)	S IH T IH Z AH N Z
CITY	S IH T IY
CITY'S	S IH T IY Z
CIVIL	S IH V AH L
CIVILIAN	S AH V IH L Y AH N
CLAIM	K L EY M
CLAIMED	K L EY M D
CLAIMING	K L EY M IH NG
CLAIMS	K L EY M Z
CLARK	K L AA R K
CLASS	K L AE S
CLASSES	K L AE S AH Z
CLASSES(2)	K L AE S IH Z
CLASSIC	K L AE S IH K
CLASSIFIED	K L AE S AH F AY D
CLEAN	K L IY N
CLEAR	K L IH R
CLEARANCE	K L IH R AH N S
CLEARED	K L IH R D
CLEARING	K L IH R IH NG
CLEARLY	K L IH R L IY
CLEVELAND	K L IY V L AH N D
CLIENT	K L AY AH N T
CLIENTS	K L AY AH N T S
CLIMATE	K L AY M AH T
CLIMATE(2)	K L AY M IH T
CLIMB	K L AY M
CLIMBED	K L AY M D
CLINICAL	K L IH N AH K AH L
CLINICAL(2)	K L IH N IH K AH L
CLOSE	K L OW S
CLOSE(2)	K L OW Z
CLOSED	K L OW Z D
CLOSELY	K L OW S L IY
CLOSER	K L OW S ER
CLOSER(2)	K L OW Z ER
CLOSING	K L OW Z IH NG
CLOSINGS	K L OW Z IH NG Z
CLOTHES	K L OW DH Z
CLOTHES(2)	K L OW Z
CLOTHING	K L OW DH IH NG
CLUB	K L AH B
CLUBS	K L AH B Z
CO	K OW
COAL	K OW L
COALITION	K OW AH L IH SH AH N
COAST	K OW S T
COASTAL	K OW S T AH L
COCA	K OW K AH
COCAINE	K OW K EY N
COCOA	K OW K OW
CODE	K OW D
COFFEE	K AA F IY
COFFEE(2)	K AO F IY
COHEN	K OW AH N
COKE	K OW K
COLA	K OW L AH
COLD	K OW L D
COLLAPSE	K AH L AE P S
COLLAPSED	K AH L AE P S T
COLLAR	K AA L ER
COLLATERAL	K AH L AE T ER AH L
COLLEAGUES	K AA L IY G Z
COLLECT	K AH L EH K T
COLLECTED	K AH L EH K T AH D
COLLECTION	K AH L EH K SH AH N
COLLEGE	K AA L IH JH
COLLEGES	K AA L IH JH IH Z
COLONEL	K ER N AH L
COLOR	K AH L ER
COLOR(2)	K AO L ER
COLORADO	K AA L ER AA D OW
COLORADO(2)	K AA L ER AE D OW
COLUMBIA	K AH L AH M B IY AH
COLUMBUS	K AH L AH M B AH S
COLUMN	K AA L AH M
COMBAT	K AA M B AE T
COMBAT(2)	K AH M B AE T
COMBINATION	K AA M B AH N EY SH AH N
COMBINED	K AH M B AY N D
COME	K AH M
COMES	K AH M Z
COMFORTABLE	K AH M F ER T AH B AH L
COMING	K AH M IH NG
COMMAND	K AH M AE N D
COMMENT	K AA M EH N T
COMMENTS	K AA M EH N T S
COMMERCE	K AA M ER S
COMMERCIAL	K AH M ER SH AH L
COMMERCIALS	K AH M ER SH AH L Z
COMMISSION	K AH M IH SH AH N
COMMISSION'S	K AH M IH SH AH N Z
COMMISSIONER	K AH M IH SH AH N ER
COMMISSIONS	K AH M IH SH AH N Z
COMMITMENT	K AH M IH T M AH N T
COMMITMENTS	K AH M IH T M AH N T S
COMMITTED	K AH M IH T AH D
COMMITTEE	K AH M IH T IY
COMMITTEE'S	K AH M IH T IY Z
COMMITTEES	K AH M IH T IY Z
COMMODITIES	K AH M AA D AH T IY Z
COMMODITY	K AH M AA D AH T IY
COMMON	K AA M AH N
COMMONWEALTH	K AA M AH N W EH L TH
COMMUNICATION	K AH M Y UW N AH K EY SH AH N
COMMUNICATIONS	K AH M Y UW N AH K EY SH AH N Z
COMMUNIST	K AA M Y AH N AH S T
COMMUNITIES	K AH M Y UW N AH T IY Z
COMMUNITIES(2)	K AH M Y UW N IH T IY Z
COMMUNITY	K AH M Y UW N AH T IY
COMMUNITY(2)	K AH M Y UW N IH T IY
COMPACT	K AA M P AE K T
COMPACT(2)	K AH M P AE K T
COMPANIES	K AH M P AH N IY Z
COMPANIES'	K AH M P AH N IY Z
COMPANY	K AH M P AH N IY
COMPANY'S	K AH M P AH N IY Z
COMPAQ	K AA M P AE K
COMPARABLE	K AA M P ER AH B AH L
COMPARABLE(2)	K AH M P EH R AH B AH L
COMPARABLE(3)	K AH M P R AH B AH L
COMPARED	K AH M P EH R D
COMPARISON	K AH M P EH R AH S AH N
COMPENSATION	K AA M P AH N S EY SH AH N
COMPETE	K AH M P IY T
COMPETING	K AH M P IY T IH NG
COMPETITION	K AA M P AH T IH SH AH N
COMPETITIVE	K AH M P EH T AH T IH V
COMPETITIVE(2)	K AH M P EH T IH T IH V
COMPETITIVENESS	K AH M P EH T IH T IH V N IH S
COMPETITOR	K AH M P EH T AH T ER
COMPETITOR(2)	K AH M P EH T IH T ER
COMPETITORS	K AH M P EH T AH T ER Z
COMPETITORS(2)	K AH M P EH T IH T ER Z
COMPLAIN	K AH M P L EY N
COMPLAINED	K AH M P L EY N D
COMPLAINS	K AH M P L EY N Z
COMPLAINT	K AH M P L EY N T
COMPLAINTS	K AH M P L EY N T S
COMPLETE	K AH M P L IY T
COMPLETED	K AH M P L IY T AH D
COMPLETED(2)	K AH M P L IY T IH D
COMPLETELY	K AH M P L IY T L IY
COMPLETION	K AH M P L IY SH AH N
COMPLEX	K AA M P L EH K S
COMPLEX(2)	K AH M P L EH K S
COMPLIANCE	K AH M P L AY AH N S
COMPLICATED	K AA M P L AH K EY T AH D
COMPLY	K AH M P L AY
COMPONENTS	K AH M P OW N AH N T S
COMPOSITE	K AA M P AA Z AH T
COMPOSITE(2)	K AH M P AA Z AH T
COMPREHENSIVE	K AA M P R IY HH EH N S IH V
COMPROMISE	K AA M P R AH M AY Z
COMPUTER	K AH M P Y UW T ER
COMPUTERIZED	K AH M P Y UW T ER AY Z D
COMPUTERS	K AH M P Y UW T ER Z
CONCEDE	K AH N S IY D
CONCEDED	K AH N S IY D IH D
CONCEDES	K AH N S IY D Z
CONCENTRATE	K AA N S AH N T R EY T
CONCEPT	K AA N S EH P T
CONCERN	K AH N S ER N
CONCERN'S	K AH N S ER N Z
CONCERNED	K AH N S ER N D
CONCERNING	K AH N S ER N IH NG
CONCERNS	K AH N S ER N Z
CONCESSIONS	K AH N S EH SH AH N Z
CONCLUDE	K AH N K L UW D
CONCLUDED	K AH N K L UW D AH D
CONCLUDED(2)	K AH N K L UW D IH D
CONCLUSION	K AH N K L UW ZH AH N
CONCRETE	K AA N K R IY T
CONCRETE(2)	K AH N K R IY T
CONDITION	K AH N D IH SH AH N
CONDITIONS	K AH N D IH SH AH N Z
CONDUCT	K AA N D AH K T
CONDUCT(2)	K AH N D AH K T
CONDUCTED	K AH N D AH K T AH D
CONDUCTING	K AH N D AH K T IH NG
CONFERENCE	K AA N F ER AH N S
CONFERENCE(2)	K AA N F R AH N S
CONFIDENCE	K AA N F AH D AH N S
CONFIDENT	K AA N F AH D AH N T
CONFIDENTIAL	K AA N F AH D EH N CH AH L
CONFIDENTIAL(2)	K AA N F AH D EH N SH AH L
CONFIRM	K AH N F ER M
CONFIRMATION	K AA N F ER M EY SH AH N
CONFIRMED	K AH N F ER M D
CONFLICT	K AA N F L IH K T
CONFLICT(2)	K AH N F L IH K T
CONFLICTS	K AA N F L IH K S
CONFLICTS(2)	K AA N F L IH K T S
CONFLICTS(3)	K AH N F L IH K S
CONFLICTS(4)	K AH N F L IH K T S
CONFUSION	K AH N F Y UW ZH AH N
CONGRESS	K AA NG G R AH S
CONGRESSIONAL	K AH N G R EH SH AH N AH L
CONISTON	K AA N AH S T AH N
CONNECTICUT	K AH N EH T AH K AH T
CONNECTION	K AH N EH K SH AH N
CONSECUTIVE	K AH N S EH K Y AH T IH V
CONSENSUS	K AH N S EH N S AH S
CONSENT	K AH N S EH N T
CONSEQUENCES	K AA N S AH K W EH N S AH Z
CONSERVATIVE	K AH N S ER V AH T IH V
CONSERVATIVES	K AH N S ER V AH T IH V Z
CONSIDER	K AH N S IH D ER
CONSIDERABLE	K AH N S IH D ER AH B AH L
CONSIDERABLY	K AH N S IH D ER AH B L IY
CONSIDERATION	K AH N S IH D ER EY SH AH N
CONSIDERED	K AH N S IH D ER D
CONSIDERING	K AH N S IH D ER IH NG
CONSIDERS	K AH N S IH D ER Z
CONSISTENT	K AH N S IH S T AH N T
CONSISTENTLY	K AH N S IH S T AH N T L IY
CONSISTS	K AH N S IH S
CONSISTS(2)	K AH N S IH S S
CONSISTS(3)	K AH N S IH S T S
CONSOLIDATED	K AH N S AA L AH D EY T AH D
CONSOLIDATION	K AH N S AA L AH D EY SH AH N
CONSORTIUM	K AH N S AO R SH IY AH M
CONSORTIUM(2)	K AH N S AO R SH Y AH M
CONSPIRACY	K AH N S P IH R AH S IY
CONSTANT	K AA N S T AH N T
CONSTITUTION	K AA N S T AH T UW SH AH N
CONSTITUTIONAL	K AA N S T AH T UW SH AH N AH L
CONSTRUCTION	K AH N S T R AH K SH AH N
CONSULTANT	K AH N S AH L T AH N T
CONSULTANTS	K AH N S AH L T AH N T S
CONSULTING	K AH N S AH L T IH NG
CONSUMER	K AH N S UW M ER
CONSUMERS	K AH N S UW M ER Z
CONSUMPTION	K AH N S AH M P SH AH N
CONSUMPTION(2)	K AH N S AH M SH AH N
CONTACT	K AA N T AE K T
CONTACTS	K AA N T AE K S
CONTACTS(2)	K AA N T AE K T S
CONTAIN	K AH N T EY N
CONTAINED	K AH N T EY N D
CONTAINS	K AH N T EY N Z
CONTEND	K AH N T EH N D
CONTENDED	K AH N T EH N D IH D
CONTENDS	K AH N T EH N D Z
CONTENDS(2)	K AH N T EH N Z
CONTENT	K AA N T EH N T
CONTENT(2)	K AH N T EH N T
CONTEST	K AA N T EH S T
CONTEST(2)	K AH N T EH S T
CONTINENTAL	K AA N T AH N EH N AH L
CONTINENTAL(2)	K AA N T AH N EH N T AH L
CONTINGENT	K AH N T IH N JH AH N T
CONTINUE	K AH N T IH N Y UW
CONTINUED	K AH N T IH N Y UW D
CONTINUES	K AH N T IH N Y UW Z
CONTINUING	K AH N T IH N Y UW IH NG
CONTRA	K AA N T R AH
CONTRACT	K AA N T R AE K T
CONTRACT(2)	K AH N T R AE K T
CONTRACTOR	K AA N T R AE K T ER
CONTRACTORS	K AA N T R AE K T ER Z
CONTRACTS	K AA N T R AE K T S
CONTRACTS(2)	K AH N T R AE K T S
CONTRARY	K AA N T R EH R IY
CONTRARY(2)	K AH N T R EH R IY
CONTRAS	K AA N T R AH Z
CONTRAS(2)	K AO N T R AH Z
CONTRAST	K AA N T R AE S T
CONTRAST(2)	K AH N T R AE S T
CONTRIBUTE	K AH N T R IH B Y UW T
CONTRIBUTED	K AH N T R IH B Y UW T IH D
CONTRIBUTION	K AA N T R AH B Y UW SH AH N
CONTRIBUTIONS	K AA N T R AH B Y UW SH AH N Z
CONTROL	K AH N T R OW L
CONTROLLED	K AH N T R OW L D
CONTROLLING	K AH N T R OW L IH NG
CONTROLS	K AH N T R OW L Z
CONTROVERSIAL	K AA N T R AH V ER SH AH L
CONTROVERSY	K AA N T R AH V ER S IY
CONVENTION	K AH N V EH N SH AH N
CONVENTIONAL	K AH N V EH N SH AH N AH L
CONVERSION	K AH N V ER ZH AH N
CONVERT	K AA N V ER T
CONVERT(2)	K AH N V ER T
CONVERTED	K AH N V ER T IH D
CONVERTIBLE	K AH N V ER T AH B AH L
CONVICTED	K AH N V IH K T AH D
CONVICTION	K AH N V IH K SH AH N
CONVINCE	K AH N V IH N S
CONVINCED	K AH N V IH N S T
COOL	K UW L
COOPER	K UW P ER
COOPERATE	K OW AA P ER EY T
COOPERATE(2)	K W AA P ER EY T
COOPERATION	K OW AA P ER EY SH AH N
COOPERATION(2)	K W AA P ER EY SH AH N
COOPERATION(3)	K W AO P ER EY SH AH N
COPIES	K AA P IY Z
COPPER	K AA P ER
COPY	K AA P IY
CORE	K AO R
CORN	K AO R N
CORNER	K AO R N ER
CORPORATE	K AO R P ER AH T
CORPORATE(2)	K AO R P R AH T
CORPORATION	K AO R P ER EY SH AH N
CORPORATION'S	K AO R P ER EY SH AH N Z
CORPORATIONS	K AO R P ER EY SH AH N Z
CORRECT	K ER EH K T
CORRECTION	K ER EH K SH AH N
CORRUPTION	K ER AH P SH AH N
COST	K AA S T
COST(2)	K AO S T
COSTA	K AO S T AH
COSTLY	K AA S T L IY
COSTLY(2)	K AO S T L IY
COSTS	K AA S T S
COSTS(2)	K AO S
COSTS(3)	K AO S S
COSTS(4)	K AO S T S
COTTON	K AA T AH N
COTTON(2)	K AO T AH N
COULD	K UH D
COULDN'T	K UH D AH N
COULDN'T(2)	K UH D AH N T
COUNCIL	K AW N S AH L
COUNSEL	K AW N S AH L
COUNT	K AW N T
COUNTER	K AW N T ER
COUNTING	K AW N IH NG
COUNTING(2)	K AW N T IH NG
COUNTRIES	K AH N T R IY Z
COUNTRY	K AH N T R IY
COUNTRY'S	K AH N T R IY Z
COUNTS	K AW N T S
COUNTY	K AW N IY
COUNTY(2)	K AW N T IY
COUP	K UW
COUPLE	K AH P AH L
COUPON	K UW P AO N
COUPON(2)	K Y UW P AO N
COURSE	K AO R S
COURT	K AO R T
COURT'S	K AO R T S
COURTS	K AO R T S
COVER	K AH V ER
COVERAGE	K AH V ER AH JH
COVERAGE(2)	K AH V ER IH JH
COVERAGE(3)	K AH V R IH JH
COVERED	K AH V ER D
COVERING	K AH V ER IH NG
COVERING(2)	K AH V R IH NG
COVERS	K AH V ER Z
CRACK	K R AE K
CRAFT	K R AE F T
CRASH	K R AE SH
CRAY	K R EY
CRAZY	K R EY Z IY
CREATE	K R IY EY T
CREATED	K R IY EY T AH D
CREATED(2)	K R IY EY T IH D
CREATING	K R IY EY T IH NG
CREATION	K R IY EY SH AH N
CREATIVE	K R IY EY T IH V
CREDIBILITY	K R EH D AH B IH L IH T IY
CREDIT	K R EH D AH T
CREDIT(2)	K R EH D IH T
CREDITOR	K R EH D AH T ER
CREDITOR(2)	K R EH D IH T ER
CREDITORS	K R EH D IH T ER Z
CREDITS	K R EH D IH T S
CREW	K R UW
CRIME	K R AY M
CRIMES	K R AY M Z
CRIMINAL	K R IH M AH N AH L
CRISIS	K R AY S AH S
CRITICAL	K R IH T IH K AH L
CRITICISM	K R IH T IH S IH Z AH M
CRITICIZED	K R IH T AH S AY Z D
CRITICS	K R IH T IH K S
CROP	K R AA P
CROPS	K R AA P S
CROSS	K R AO S
CROWD	K R AW D
CRUCIAL	K R UW SH AH L
CRUDE	K R UW D
CRUISE	K R UW Z
CUBAN	K Y UW B AH N
CUBIC	K Y UW B IH K
CULTURAL	K AH L CH ER AH L
CULTURE	K AH L CH ER
CUMULATIVE	K Y UW M Y AH L AH T IH V
CURB	K ER B
CURRENCIES	K ER AH N S IY Z
CURRENCY	K ER AH N S IY
CURRENT	K AA R AH N T
CURRENT(2)	K ER AH N T
CURRENT(3)	K ER N T
CURRENTLY	K ER AH N T L IY
CUSTOMER	K AH S T AH M ER
CUSTOMERS	K AH S T AH M ER Z
CUSTOMS	K AH S T AH M Z
CUT	K AH T
CUTBACKS	K AH T B AE K S
CUTS	K AH T S
CUTTING	K AH T IH NG
CYCLE	S AY K AH L
D.	D IY
D.S	D IY Z
DAILY	D EY L IY
DAIMLER	D EH M L ER
DAIMLER(2)	D EY M L ER
DALLAS	D AE L AH S
DAMAGE	D AE M AH JH
DAMAGE(2)	D AE M IH JH
DAMAGED	D AE M AH JH D
DAMAGED(2)	D AE M IH JH D
DAMAGES	D AE M AH JH AH Z
DAMAGES(2)	D AE M IH JH IH Z
DAN	D AE N
DANCE	D AE N S
DANGER	D EY N JH ER
DANGEROUS	D EY N JH ER AH S
DANIEL	D AE N Y AH L
DARK	D AA R K
DATA	D AE T AH
DATA(2)	D EY T AH
DATE	D EY T
DATES	D EY T S
DAUGHTER	D AO T ER
DAVID	D EY V IH D
DAVIS	D EY V AH S
DAVIS(2)	D EY V IH S
DAY	D EY
DAY'S	D EY Z
DAYS	D EY Z
DAYTON	D EY T AH N
DE	D AH
DE(2)	D EY
DE(3)	D IY
DEAD	D EH D
DEADLINE	D EH D L AY N
DEAL	D IY L
DEALER	D IY L ER
DEALERS	D IY L ER Z
DEALING	D IY L IH NG
DEALINGS	D IY L IH NG Z
DEALS	D IY L Z
DEAN	D IY N
DEATH	D EH TH
DEATHS	D EH TH S
DEBATE	D AH B EY T
DEBENTURES	D AH B EH N CH ER Z
DEBT	D EH T
DEBTOR	D EH T ER
DEBTS	D EH T S
DECADE	D EH K EY D
DECADES	D EH K EY D Z
DECEMBER	D IH S EH M B ER
DECIDE	D IH S AY D
DECIDED	D IH S AY D IH D
DECIDING	D AH S AY D IH NG
DECISION	D IH S IH ZH AH N
DECISIONS	D IH S IH ZH AH N Z
DECLARED	D IH K L EH R D
DECLINE	D IH K L AY N
DECLINED	D IH K L AY N D
DECLINES	D IH K L AY N Z
DECLINING	D IH K L AY N IH NG
DECREASE	D IH K R IY S
DECREASE(2)	D IY K R IY S
DEDUCTIONS	D IH D AH K SH AH N Z
DEEP	D IY P
DEEPLY	D IY P L IY
DEFAULT	D IH F AO L T
DEFEAT	D IH F IY T
DEFEND	D IH F EH N D
DEFENDANTS	D IH F EH N D AH N T S
DEFENSE	D IH F EH N S
DEFENSES	D IH F EH N S AH Z
DEFENSES(2)	D IH F EH N S IH Z
DEFENSIVE	D IH F EH N S IH V
DEFERRED	D IH F ER D
DEFICIENCY	D IH F IH SH AH N S IY
DEFICIT	D EH F AH S AH T
DEFICITS	D EH F IH S IH T S
DEFINED	D IH F AY N D
DEFINITION	D EH F AH N IH SH AH N
DEFINITIVE	D IH F IH N IH T IH V
DEGREE	D IH G R IY
DEGREES	D IH G R IY Z
DELAWARE	D EH L AH W EH R
DELAY	D IH L EY
DELAYED	D IH L EY D
DELAYS	D IH L EY Z
DELEGATES	D EH L AH G AH T S
DELEGATES(2)	D EH L AH G EY T S
DELIVER	D IH L IH V ER
DELIVERED	D IH L IH V ER D
DELIVERIES	D IH L IH V ER IY Z
DELIVERIES(2)	D IH L IH V R IY Z
DELIVERY	D IH L IH V ER IY
DELTA	D EH L T AH
DEMAND	D IH M AE N D
DEMANDED	D IH M AE N D AH D
DEMANDED(2)	D IH M AE N D IH D
DEMANDING	D IH M AE N D IH NG
DEMANDS	D IH M AE N D Z
DEMOCRACY	D IH M AA K R AH S IY
DEMOCRAT	D EH M AH K R AE T
DEMOCRATIC	D EH M AH K R AE T IH K
DEMOCRATS	D EH M AH K R AE T S
DEMONSTRATE	D EH M AH N S T R EY T
DEMONSTRATED	D EH M AH N S T R EY T AH D
DEMONSTRATED(2)	D EH M AH N S T R EY T IH D
DENIED	D IH N AY D
DENIES	D IH N AY Z
DENNIS	D EH N IH S
DENOMINATED	D IH N AA M AH N EY T IH D
DENVER	D EH N V ER
DENY	D IH N AY
DENYING	D IH N AY IH NG
DEPARTMENT	D IH P AA R T M AH N T
DEPARTMENT'S	D IH P AA R T M AH N T S
DEPARTMENTS	D IH P AA R T M AH N T S
DEPARTURE	D IH P AA R CH ER
DEPEND	D IH P EH N D
DEPENDENT	D IH P EH N D AH N T
DEPENDING	D IH P EH N D IH NG
DEPENDS	D IH P EH N D Z
DEPOSIT	D AH P AA Z IH T
DEPOSIT(2)	D IH P AA Z AH T
DEPOSITS	D AH P AA Z IH T S
DEPOSITS(2)	D IH P AA Z AH T S
DEPRESSED	D IH P R EH S T
DEPRESSION	D IH P R EH SH AH N
DEPUTY	D EH P Y AH T IY
DEPUTY(2)	D EH P Y UW T IY
DEREGULATION	D IY R EH G Y AH L EY SH AH N
DES	D EH
DES(2)	D IH
DESCRIBE	D IH S K R AY B
DESCRIBED	D IH S K R AY B D
DESCRIBES	D IH S K R AY B Z
DESIGN	D IH Z AY N
DESIGNED	D IH Z AY N D
DESIGNER	D IH Z AY N ER
DESIGNS	D IH Z AY N Z
DESIRE	D IH Z AY ER
DESK	D EH S K
DESPITE	D IH S P AY T
DESTROYED	D IH S T R OY D
DETAILED	D IH T EY L D
DETAILS	D IH T EY L Z
DETAILS(2)	D IY T EY L Z
DETERMINE	D AH T ER M AH N
DETERMINE(2)	D IH T ER M AH N
DETERMINED	D IH T ER M AH N D
DETROIT	D IH T R OY T
DETROIT(2)	D IY T R OY T
DEUTSCHE	D OY CH
DEVELOP	D IH V EH L AH P
DEVELOPED	D IH V EH L AH P T
DEVELOPER	D IH V EH L AH P ER
DEVELOPERS	D IH V EH L AH P ER Z
DEVELOPING	D IH V EH L AH P IH NG
DEVELOPMENT	D IH V EH L AH P M AH N T
DEVELOPMENTS	D IH V EH L AH P M AH N T S
DEVICE	D IH V AY S
DEVICES	D IH V AY S AH Z
DEVICES(2)	D IH V AY S IH Z
DIAMOND	D AY M AH N D
DID	D IH D
DIDN'T	D IH D AH N
DIDN'T(2)	D IH D AH N T
DIDN'T(3)	D IH D N T
DIDN'T(4)	D IH N T
DIE	D AY
DIED	D AY D
DIEGO	D IY EY G OW
DIFFERENCE	D IH F ER AH N S
DIFFERENCE(2)	D IH F R AH N S
DIFFERENCES	D IH F ER AH N S IH Z
DIFFERENCES(2)	D IH F R AH N S AH Z
DIFFERENT	D IH F ER AH N T
DIFFERENT(2)	D IH F R AH N T
DIFFICULT	D IH F AH K AH L T
DIFFICULTIES	D IH F AH K AH L T IY Z
DIFFICULTIES(2)	D IH F IH K AH L T IY Z
DIFFICULTY	D IH F AH K AH L T IY
DIFFICULTY(2)	D IH F IH K AH L T IY
DIGITAL	D IH JH AH T AH L
DIGITAL(2)	D IH JH IH T AH L
DILUTED	D AY L UW T AH D
DILUTED(2)	D IH L UW T AH D
DINNER	D IH N ER
DIPLOMATIC	D IH P L AH M AE T IH K
DIPLOMATS	D IH P L AH M AE T S
DIRECT	D AY R EH K T
DIRECT(2)	D ER EH K T
DIRECT(3)	D IH R EH K T
DIRECT(4)	D IY R EH K T
DIRECTED	D AY R EH K T IH D
DIRECTED(2)	D ER EH K T AH D
DIRECTED(3)	D ER EH K T IH D
DIRECTED(4)	D IH R EH K T IH D
DIRECTED(5)	D IY R EH K T IH D
DIRECTION	D AY R EH K SH IH N
DIRECTION(2)	D ER EH K SH AH N
DIRECTION(3)	D IH R EH K SH IH N
DIRECTION(4)	D IY R EH K SH IH N
DIRECTLY	D AY R EH K L IY
DIRECTLY(2)	D ER EH K T L IY
DIRECTLY(3)	D IH R EH K L IY
DIRECTLY(4)	D IY R EH K L IY
DIRECTOR	D AY R EH K T ER
DIRECTOR(2)	D ER EH K T ER
DIRECTOR(3)	D IH R EH K T ER
DIRECTOR(4)	D IY R EH K T ER
DIRECTORS	D AY R EH K T ER Z
DIRECTORS(2)	D ER EH K T ER Z
DIRECTORS(3)	D IH R EH K T ER Z
DIRECTORS(4)	D IY R EH K T ER Z
DISAPPOINTED	D IH S AH P OY N IH D
DISAPPOINTED(2)	D IH S AH P OY N T IH D
DISAPPOINTING	D IH S AH P OY N IH NG
DISAPPOINTING(2)	D IH S AH P OY N T IH NG
DISASTER	D IH Z AE S T ER
DISCLOSE	D IH S K L OW Z
DISCLOSED	D IH S K L OW Z D
DISCLOSURE	D IH S K L OW ZH ER
DISCONTINUED	D IH S K AH N T IH N Y UW D
DISCOUNT	D IH S K AW N T
DISCOUNTS	D IH S K AW N T S
DISCOURAGE	D IH S K ER IH JH
DISCOVERED	D IH S K AH V ER D
DISCOVERY	D IH S K AH V ER IY
DISCOVERY(2)	D IH S K AH V R IY
DISCRIMINATION	D IH S K R IH M AH N EY SH AH N
DISCUSS	D IH S K AH S
DISCUSSED	D IH S K AH S T
DISCUSSING	D IH S K AH S IH NG
DISCUSSION	D IH S K AH SH AH N
DISCUSSIONS	D IH S K AH SH AH N Z
DISEASE	D IH Z IY Z
DISK	D IH S K
DISMISSED	D IH S M IH S T
DISNEY	D IH Z N IY
DISPLAY	D IH S P L EY
DISPOSAL	D IH S P OW Z AH L
DISPUTE	D IH S P Y UW T
DISPUTED	D IH S P Y UW T AH D
DISPUTED(2)	D IH S P Y UW T IH D
DISPUTES	D IH S P Y UW T S
DISTANCE	D IH S T AH N S
DISTILLERS	D IH S T IH L ER Z
DISTRIBUTE	D IH S T R IH B Y UW T
DISTRIBUTED	D IH S T R IH B Y AH T AH D
DISTRIBUTION	D IH S T R AH B Y UW SH AH N
DISTRIBUTOR	D IH S T R IH B Y AH T ER
DISTRICT	D IH S T R IH K T
DIVERSIFIED	D AY V ER S AH F AY D
DIVERSIFIED(2)	D IH V ER S AH F AY D
DIVIDED	D IH V AY D AH D
DIVIDEND	D IH V IH D EH N D
DIVIDENDS	D IH V AH D EH N D Z
DIVISION	D IH V IH ZH AH N
DIVISIONS	D IH V IH ZH AH N Z
DO	D UW
DOCTOR	D AA K T ER
DOCTOR(2)	D AO K T ER
DOCTORS	D AA K T ER Z
DOCTRINE	D AA K T R AH N
DOCTRINE(2)	D AO K T ER IH N
DOCUMENT	D AA K Y AH M EH N T
DOCUMENT(2)	D AA K Y UW M EH N T
DOCUMENTS	D AA K Y AH M AH N T S
DOCUMENTS(2)	D AA K Y UW M AH N T S
DOES	D AH Z
DOES(2)	D IH Z
DOESN'T	D AH Z AH N
DOESN'T(2)	D AH Z AH N T
DOG	D AO G
DOING	D UW IH NG
DOLE	D OW L
DOLLAR	D AA L ER
DOLLAR(2)	D AO L ER
DOLLAR'S	D AA L AH Z
DOLLAR'S(2)	D AA L ER Z
DOLLAR'S(3)	D AO L ER Z
DOLLARS	D AA L ER Z
DOLLARS(2)	D AO L ER Z
DOME	D OW M
DOMESTIC	D AH M EH S T IH K
DOMINANT	D AA M AH N AH N T
DOMINATED	D AA M AH N EY T AH D
DOMINION	D AH M IH N Y AH N
DON	D AA N
DON'T	D OW N
DON'T(2)	D OW N T
DONALD	D AA N AH L D
DONALDSON	D AA N AH L D S AH N
DONE	D AH N
DOOR	D AO R
DOORS	D AO R Z
DOUBLE	D AH B AH L
DOUBLED	D AH B AH L D
DOUBT	D AW T
DOUBTS	D AW T S
DOUGLAS	D AH G L AH S
DOW	D AW
DOWN	D AW N
DOWNS	D AW N Z
DOWNTOWN	D AW N T AW N
DOWNTURN	D AW N T ER N
DOWNWARD	D AW N W ER D
DOZEN	D AH Z AH N
DOZENS	D AH Z AH N Z
DRAFT	D R AE F T
DRAMATIC	D R AH M AE T IH K
DRAW	D R AO
DRAWING	D R AO IH NG
DRAWN	D R AO N
DREAM	D R IY M
DREW	D R UW
DREXEL	D R EH K S AH L
DREXEL'S	D R EH K S AH L Z
DRILLING	D R IH L IH NG
DRINK	D R IH NG K
DRIVE	D R AY V
DRIVEN	D R IH V AH N
DRIVERS	D R AY V ER Z
DRIVES	D R AY V Z
DRIVING	D R AY V IH NG
DROP	D R AA P
DROP(2)	D R AO P
DROPPED	D R AA P T
DROPPING	D R AA P IH NG
DROUGHT	D R AW T
DROVE	D R OW V
DRUG	D R AH G
DRUGS	D R AH G Z
DRY	D R AY
DU	D AH
DU(2)	D UW
DUE	D UW
DUE(2)	D Y UW
DUKAKIS	D UW K AA K IH S
DUMPING	D AH M P IH NG
DURABLE	D UH R AH B AH L
DURING	D ER IH NG
DURING(2)	D UH R IH NG
DURING(3)	D Y UH R IH NG
DUTCH	D AH CH
DUTIES	D UW T IY Z
DUTY	D UW T IY
DUTY(2)	D Y UW T IY
DYNAMICS	D AY N AE M IH K S
E.	IY
E.'S	IY Z
EACH	IY CH
EAGER	IY G ER
EARLIER	ER L IY ER
EARLY	ER L IY
EARN	ER N
EARNED	ER N D
EARNING	ER N IH NG
EARNINGS	ER N IH NG Z
EARTH	ER TH
EASE	IY Z
EASED	IY Z D
EASIER	IY Z IY ER
EASILY	IY Z AH L IY
EASING	IY Z IH NG
EAST	IY S T
EASTERN	IY S T ER N
EASY	IY Z IY
EAT	IY T
ECONOMIC	EH K AH N AA M IH K
ECONOMIC(2)	IY K AH N AA M IH K
ECONOMICS	EH K AH N AA M IH K S
ECONOMICS(2)	IY K AH N AA M IH K S
ECONOMIES	IH K AA N AH M IY Z
ECONOMIES(2)	IY K AA N AH M IY Z
ECONOMIST	IH K AA N AH M IH S T
ECONOMIST(2)	IY K AA N AH M IH S T
ECONOMISTS	IH K AA N AH M IH S
ECONOMISTS(2)	IH K AA N AH M IH S S
ECONOMISTS(3)	IH K AA N AH M IH S T S
ECONOMISTS(4)	IY K AA N AH M IH S
ECONOMISTS(5)	IY K AA N AH M IH S S
ECONOMY	IH K AA N AH M IY
ECONOMY(2)	IY K AA N AH M IY
EDDIE	EH D IY
EDELMAN	EH D AH L M AH N
EDELMAN(2)	EY D AH L M AH N
EDGE	EH JH
EDGED	EH JH D
EDISON	EH D IH S AH N
EDITION	AH D IH SH AH N
EDITION(2)	IH D IH SH AH N
EDITOR	EH D AH T ER
EDITOR(2)	EH D IH T ER
EDITORIAL	EH D AH T AO R IY AH L
EDUCATION	EH JH AH K EY SH AH N
EDUCATION(2)	EH JH Y UW K EY SH AH N
EDUCATIONAL	EH JH AH K EY SH AH N AH L
EDUCATIONAL(2)	EH JH Y UW K EY SH AH N AH L
EDWARD	EH D W ER D
EDWIN	EH D W AH N
EDWIN(2)	EH D W IH N
EFFECT	AH F EH K T
EFFECT(2)	IH F EH K T
EFFECT(3)	IY F EH K T
EFFECTIVE	IH F EH K T IH V
EFFECTIVE(2)	IY F EH K T IH V
EFFECTIVELY	IH F EH K T IH V L IY
EFFECTIVELY(2)	IY F EH K T IH V L IY
EFFECTS	IH F EH K S
EFFECTS(2)	IH F EH K T S
EFFECTS(3)	IY F EH K S
EFFECTS(4)	IY F EH K T S
EFFICIENCY	IH F IH SH AH N S IY
EFFICIENT	IH F IH SH AH N T
EFFORT	EH F ER T
EFFORTS	EH F ER T S
EGYPT	IY JH AH P T
EGYPT(2)	IY JH IH P T
EIGHT	EY T
EIGHTEEN	EY T IY N
EIGHTEENTH	EY T IY N TH
EIGHTH	EY T TH
EIGHTH(2)	EY TH
EIGHTHS	EY T TH S
EIGHTIES	EY T IY Z
EIGHTY	EY T IY
EITHER	AY DH ER
EITHER(2)	IY DH ER
EL	EH L
ELABORATE	IH L AE B ER EY T
ELABORATE(2)	IH L AE B R AH T
ELDERLY	EH L D ER L IY
ELDERS	EH L D ER Z
ELECT	IH L EH K T
ELECTED	IH L EH K T AH D
ELECTED(2)	IH L EH K T IH D
ELECTION	IH L EH K SH AH N
ELECTIONS	IH L EH K SH AH N Z
ELECTRIC	IH L EH K T R IH K
ELECTRICAL	IH L EH K T R IH K AH L
ELECTRICITY	IH L EH K T R IH S AH T IY
ELECTRONIC	IH L EH K T R AA N IH K
ELECTRONICS	IH L EH K T R AA N IH K S
ELEMENTS	EH L AH M AH N T S
ELEVEN	IH L EH V AH N
ELEVEN(2)	IY L EH V AH N
ELEVENTH	IH L EH V AH N TH
ELEVENTH(2)	IY L EH V AH N TH
ELIGIBLE	EH L AH JH AH B AH L
ELIGIBLE(2)	EH L IH JH AH B AH L
ELIMINATE	IH L IH M AH N EY T
ELIMINATED	IH L IH M AH N EY T AH D
ELIMINATED(2)	IH L IH M AH N EY T IH D
ELIMINATING	IH L IH M AH N EY T IH NG
ELSE	EH L S
ELSEWHERE	EH L S W EH R
EMBASSY	EH M B AH S IY
EMERGE	IH M ER JH
EMERGE(2)	IY M ER JH
EMERGED	IH M ER JH D
EMERGED(2)	IY M ER JH D
EMERGENCY	IH M ER JH AH N S IY
EMERGENCY(2)	IY M ER JH AH N S IY
EMERGING	IH M ER JH IH NG
EMERGING(2)	IY M ER JH IH NG
EMOTIONAL	IH M OW SH AH N AH L
EMOTIONAL(2)	IY M OW SH AH N AH L
EMPHASIS	EH M F AH S AH S
EMPHASIS(2)	EH M F AH S IH S
EMPHASIZED	EH M F AH S AY Z D
EMPIRE	EH M P AY ER
EMPLOYED	EH M P L OY D
EMPLOYED(2)	IH M P L OY D
EMPLOYEE	EH M P L OY IY
EMPLOYEE(2)	IH M P L OY IY
EMPLOYEES	EH M P L OY IY Z
EMPLOYEES(2)	IH M P L OY IY Z
EMPLOYER	EH M P L OY ER
EMPLOYER(2)	IH M P L OY ER
EMPLOYERS	EH M P L OY ER Z
EMPLOYERS(2)	IH M P L OY ER Z
EMPLOYMENT	EH M P L OY M AH N T
EMPLOYMENT(2)	IH M P L OY M AH N T
EMPLOYS	EH M P L OY Z
EMPLOYS(2)	IH M P L OY Z
ENABLE	EH N EY B AH L
ENABLE(2)	IH N EY B AH L
ENACTED	EH N AE K T AH D
ENCOURAGE	EH N K ER IH JH
ENCOURAGE(2)	IH N K ER AH JH
ENCOURAGED	EH N K ER IH JH D
ENCOURAGED(2)	IH N K ER AH JH D
ENCOURAGING	EH N K ER IH JH IH NG
ENCOURAGING(2)	IH N K ER AH JH IH NG
END	EH N D
ENDED	EH N D AH D
ENDED(2)	EH N D IH D
ENDING	EH N D IH NG
ENDORSED	EH N D AO R S T
ENDS	EH N D Z
ENERGY	EH N ER JH IY
ENFORCEMENT	EH N F AO R S M AH N T
ENGAGED	EH N G EY JH D
ENGINE	EH N JH AH N
ENGINE(2)	IH N JH AH N
ENGINEER	EH N JH AH N IH R
ENGINEERED	EH N JH AH N IY R D
ENGINEERING	EH N JH AH N IH R IH NG
ENGINEERS	EH N JH AH N IH R Z
ENGINES	EH N JH AH N Z
ENGLAND	IH NG G L AH N D
ENGLISH	IH NG G L IH SH
ENGLISH(2)	IH NG L IH SH
ENHANCE	EH N HH AE N S
ENJOY	EH N JH OY
ENJOY(2)	IH N JH OY
ENORMOUS	IH N AO R M AH S
ENORMOUS(2)	IH N AO R M IH S
ENORMOUS(3)	IY N AO R M AH S
ENORMOUS(4)	IY N AO R M IH S
ENOUGH	IH N AH F
ENOUGH(2)	IY N AH F
ENSURE	EH N SH UH R
ENSURE(2)	IH N SH UH R
ENTER	EH N ER
ENTER(2)	EH N T ER
ENTERED	EH N ER D
ENTERED(2)	EH N T ER D
ENTERING	EH N ER IH NG
ENTERING(2)	EH N T ER IH NG
ENTERPRISE	EH N ER P R AY Z
ENTERPRISE(2)	EH N T ER P R AY Z
ENTERPRISES	EH N ER P R AY Z IH Z
ENTERPRISES(2)	EH N T ER P R AY Z IH Z
ENTERTAINMENT	EH N ER T EY N M AH N T
ENTERTAINMENT(2)	EH N T ER T EY N M AH N T
ENTHUSIASM	IH N TH UW Z IY AE Z AH M
ENTIRE	IH N T AY ER
ENTIRELY	IH N T AY ER L IY
ENTITLED	EH N T AY T AH L D
ENTREPRENEURS	AA N T R AH P R AH N ER Z
ENTRY	EH N T R IY
ENVIRONMENT	IH N V AY R AH N M AH N T
ENVIRONMENTAL	IH N V AY R AH N M EH N AH L
ENVIRONMENTAL(2)	IH N V AY R AH N M EH N T AH L
EQUAL	IY K W AH L
EQUALLY	IY K W AH L IY
EQUIPMENT	IH K W IH P M AH N T
EQUIPPED	IH K W IH P T
EQUITIES	EH K W AH T IY Z
EQUITY	EH K W AH T IY
EQUIVALENT	IH K W IH V AH L AH N T
ERA	EH R AH
ERA(2)	IH R AH
ERROR	EH R ER
ESCAPE	IH S K EY P
ESPECIALLY	AH S P EH SH AH L IY
ESPECIALLY(2)	AH S P EH SH L IY
ESSENTIAL	AH S EH N CH AH L
ESSENTIAL(2)	IH S EH N SH AH L
ESSENTIAL(3)	IY S EH N CH AH L
ESSENTIAL(4)	IY S EH N SH AH L
ESSENTIALLY	IH S EH N SH AH L IY
ESSENTIALLY(2)	IY S EH N SH AH L IY
ESTABLISH	IH S T AE B L IH SH
ESTABLISH(2)	IY S T AE B L IH SH
ESTABLISHED	IH S T AE B L IH SH T
ESTABLISHED(2)	IY S T AE B L IH SH T
ESTABLISHMENT	IH S T AE B L IH SH M AH N T
ESTABLISHMENT(2)	IY S T AE B L IH SH M AH N T
ESTATE	IH S T EY T
ESTIMATE	EH S T AH M AH T
ESTIMATE(2)	EH S T AH M EY T
ESTIMATED	EH S T AH M EY T AH D
ESTIMATED(2)	EH S T AH M EY T IH D
ESTIMATES	EH S T AH M AH T S
ESTIMATES(2)	EH S T AH M EY T S
ETHICS	EH TH IH K S
ETHNIC	EH TH N IH K
EUROBONDS	Y UW R OW B AA N D Z
EURODOLLAR	Y UH R OW D AO L ER
EURODOLLAR(2)	Y UW R OW D AA L ER
EUROPE	Y UH R AH P
EUROPE'S	Y UH R AH P S
EUROPEAN	Y UH R AH P IY AH N
EUROPEANS	Y UH R AH P IY AH N Z
EVALUATE	IH V AE L Y UW EY T
EVALUATE(2)	IY V AE L Y UW EY T
EVANS	EH V AH N Z
EVEN	IY V IH N
EVENING	IY V N IH NG
EVENT	IH V EH N T
EVENT(2)	IY V EH N T
EVENTS	IH V EH N T S
EVENTS(2)	IY V EH N T S
EVENTUALLY	IH V EH N CH AH W AH L IY
EVENTUALLY(2)	IH V EH N SH AH L IY
EVENTUALLY(3)	IY V EH N CH AH W AH L IY
EVENTUALLY(4)	IY V EH N SH AH L IY
EVER	EH V ER
EVERY	EH V ER IY
EVERY(2)	EH V R IY
EVERYBODY	EH V R IY B AA D IY
EVERYONE	EH V R IY W AH N
EVERYTHING	EH V R IY TH IH NG
EVIDENCE	EH V AH D AH N S
EVIDENT	EH V AH D AH N T
EX	EH K S
EXACTLY	IH G Z AE K T L IY
EXAMPLE	IH G Z AE M P AH L
EXCEED	IH K S IY D
EXCEEDED	IH K S IY D AH D
EXCEEDED(2)	IH K S IY D IH D
EXCELLENT	EH K S AH L AH N T
EXCEPT	IH K S EH P T
EXCEPTION	IH K S EH P SH AH N
EXCESS	EH K S EH S
EXCESS(2)	IH K S EH S
EXCESSIVE	IH K S EH S IH V
EXCHANGE	IH K S CH EY N JH
EXCHANGE'S	IH K S CH EY N JH IH Z
EXCHANGES	IH K S CH EY N JH AH Z
EXCHANGES(2)	IH K S CH EY N JH IH Z
EXCLUDING	IH K S K L UW D IH NG
EXCLUSIVE	IH K S K L UW S IH V
EXECUTIVE	IH G Z EH K Y AH T IH V
EXECUTIVES	IH G Z EH K Y AH T IH V Z
EXEMPT	IH G Z EH M P T
EXERCISE	EH K S ER S AY Z
EXIST	IH G Z IH S T
EXISTENCE	EH G Z IH S T AH N S
EXISTENCE(2)	IH G Z IH S T AH N S
EXISTING	IH G Z IH S T IH NG
EXPAND	IH K S P AE N D
EXPANDED	IH K S P AE N D AH D
EXPANDED(2)	IH K S P AE N D IH D
EXPANDING	IH K S P AE N D IH NG
EXPANSION	IH K S P AE N CH AH N
EXPANSION(2)	IH K S P AE N SH AH N
EXPECT	IH K S P EH K T
EXPECTATIONS	EH K S P EH K T EY SH AH N Z
EXPECTED	IH K S P EH K T AH D
EXPECTED(2)	IH K S P EH K T IH D
EXPECTING	IH K S P EH K T IH NG
EXPECTS	IH K S P EH K S
EXPECTS(2)	IH K S P EH K T S
EXPENDITURES	IH K S P EH N D AH CH ER Z
EXPENDITURES(2)	IH K S P EH N D IH CH ER Z
EXPENSE	IH K S P EH N S
EXPENSES	IH K S P EH N S AH Z
EXPENSES(2)	IH K S P EH N S IH Z
EXPENSIVE	IH K S P EH N S IH V
EXPERIENCE	IH K S P IH R IY AH N S
EXPERIENCED	IH K S P IH R IY AH N S T
EXPERIMENT	IH K S P EH R AH M AH N T
EXPERT	EH K S P ER T
EXPERTISE	EH K S P ER T IY Z
EXPERTS	EH K S P ER T S
EXPIRATION	EH K S P ER EY SH AH N
EXPIRE	IH K S P AY R
EXPIRED	IH K S P AY R D
EXPIRES	IH K S P AY ER Z
EXPLAIN	IH K S P L EY N
EXPLAINED	IH K S P L EY N D
EXPLAINS	IH K S P L EY N Z
EXPLANATION	EH K S P L AH N EY SH AH N
EXPLORATION	EH K S P L AO R EY SH AH N
EXPLORATION(2)	EH K S P L ER EY SH AH N
EXPLORE	IH K S P L AO R
EXPLOSION	IH K S P L OW ZH AH N
EXPORT	EH K S P AO R T
EXPORTERS	IH K S P AO R T ER Z
EXPORTING	IH K S P AO R T IH NG
EXPORTS	EH K S P AO R T S
EXPOSED	IH K S P OW Z D
EXPOSURE	IH K S P OW ZH ER
EXPRESS	IH K S P R EH S
EXPRESSED	IH K S P R EH S T
EXTEND	IH K S T EH N D
EXTENDED	IH K S T EH N D AH D
EXTENDED(2)	IH K S T EH N D IH D
EXTENDING	IH K S T EH N D IH NG
EXTENSION	IH K S T EH N SH AH N
EXTENSIVE	IH K S T EH N S IH V
EXTENT	IH K S T EH N T
EXTERNAL	IH K S T ER N AH L
EXTRA	EH K S T R AH
EXTRAORDINARY	EH K S T R AH AO R D AH N EH R IY
EXTRAORDINARY(2)	IH K S T R AO R D AH N EH R IY
EXTREME	IH K S T R IY M
EXTREMELY	IH K S T R IY M L IY
EXXON	EH K S AA N
EYE	AY
EYES	AY Z
F.	EH F
FACE	F EY S
FACED	F EY S T
FACES	F EY S AH Z
FACES(2)	F EY S IH Z
FACILITIES	F AH S IH L AH T IY Z
FACILITIES(2)	F AH S IH L IH T IY Z
FACILITY	F AH S IH L IH T IY
FACING	F EY S IH NG
FACT	F AE K T
FACTOR	F AE K T ER
FACTORIES	F AE K T ER IY Z
FACTORS	F AE K T ER Z
FACTORY	F AE K T ER IY
FACTS	F AE K S
FACTS(2)	F AE K T S
FAIL	F EY L
FAILED	F EY L D
FAILING	F EY L IH NG
FAILS	F EY L Z
FAILURE	F EY L Y ER
FAILURES	F EY L Y ER Z
FAIR	F EH R
FAIRLY	F EH R L IY
FAITH	F EY TH
FALL	F AA L
FALL(2)	F AO L
FALLEN	F AA L AH N
FALLING	F AA L IH NG
FALLS	F AO L Z
FALSE	F AO L S
FAMILIAR	F AH M IH L Y ER
FAMILIES	F AE M AH L IY Z
FAMILIES(2)	F AE M L IY Z
FAMILY	F AE M AH L IY
FAMILY(2)	F AE M L IY
FAMOUS	F EY M AH S
FANNIE	F AE N IY
FANS	F AE N Z
FAR	F AA R
FARE	F EH R
FARES	F EH R Z
FARM	F AA R M
FARMER	F AA R M ER
FARMERS	F AA R M ER Z
FARMS	F AA R M Z
FASHION	F AE SH AH N
FAST	F AE S T
FASTER	F AE S T ER
FASTEST	F AE S T AH S T
FAT	F AE T
FATE	F EY T
FATHER	F AA DH ER
FAVOR	F EY V ER
FAVORABLE	F EY V ER AH B AH L
FAVORABLE(2)	F EY V R AH B AH L
FAVORED	F EY V ER D
FAVORITE	F EY V ER IH T
FAVORITE(2)	F EY V R AH T
FAVORS	F EY V ER Z
FE	F EY
FEAR	F IH R
FEARED	F IH R D
FEARS	F IH R Z
FEATURE	F IY CH ER
FEATURES	F IY CH ER Z
FEBRUARY	F EH B AH W EH R IY
FEBRUARY(2)	F EH B R UW W EH R IY
FEBRUARY(3)	F EH B UW W EH R IY
FEBRUARY(4)	F EH B Y AH W EH R IY
FEBRUARY(5)	F EH B Y UW W EH R IY
FED	F EH D
FED'S	F EH D Z
FEDERAL	F EH D ER AH L
FEDERAL(2)	F EH D R AH L
FEDERALLY	F EH D ER AH L IY
FEDERALLY(2)	F EH D R AH L IY
FEDERATED	F EH D ER EY T IH D
FEDERATION	F EH D ER EY SH AH N
FEE	F IY
FEED	F IY D
FEEL	F IY L
FEELING	F IY L IH NG
FEELS	F IY L Z
FEES	F IY Z
FEET	F IY T
FELL	F EH L
FELLOW	F EH L OW
FELT	F EH L T
FEMALE	F IY M EY L
FEW	F Y UW
FEWER	F Y UW ER
FIBER	F AY B ER
FIDELITY	F AH D EH L AH T IY
FIDELITY(2)	F AY D EH L AH T IY
FIELD	F IY L D
FIELDS	F IY L D Z
FIFTEEN	F IH F T IY N
FIFTEENTH	F IH F T IY N TH
FIFTH	F IH F TH
FIFTH(2)	F IH TH
FIFTIES	F IH F T IY Z
FIFTY	F IH F T IY
FIGHT	F AY T
FIGHTER	F AY T ER
FIGHTING	F AY T IH NG
FIGURE	F IH G Y ER
FIGURES	F IH G Y ER Z
FILE	F AY L
FILED	F AY L D
FILING	F AY L IH NG
FILINGS	F AY L IH NG Z
FILL	F IH L
FILLED	F IH L D
FILLING	F IH L IH NG
FILM	F IH L M
FILMS	F IH L M Z
FINAL	F AY N AH L
FINALLY	F AY N AH L IY
FINANCE	F AH N AE N S
FINANCE(2)	F AY N AE N S
FINANCE(3)	F IH N AE N S
FINANCED	F AY N AE N S T
FINANCED(2)	F IH N AE N S T
FINANCIAL	F AH N AE N SH AH L
FINANCIAL(2)	F AY N AE N SH AH L
FINANCIAL(3)	F IH N AE N SH AH L
FINANCIALLY	F AH N AE N SH AH L IY
FINANCIALLY(2)	F AY N AE N SH AH L IY
FINANCIALLY(3)	F IH N AE N SH AH L IY
FINANCIER	F AY N AE N S IH R
FINANCIER(2)	F IH N AH N S IH R
FINANCING	F AH N AE N S IH NG
FINANCING(2)	F AY N AE N S IH NG
FINANCING(3)	F IH N AE N S IH NG
FIND	F AY N D
FINDING	F AY N D IH NG
FINDINGS	F AY N D IH NG Z
FINDS	F AY N D Z
FINE	F AY N
FINED	F AY N D
FINES	F AY N Z
FINISH	F IH N IH SH
FINISHED	F IH N IH SH T
FIRE	F AY ER
FIRE(2)	F AY R
FIRED	F AY ER D
FIRM	F ER M
FIRM'S	F ER M Z
FIRMS	F ER M Z
FIRST	F ER S T
FISCAL	F IH S K AH L
FISH	F IH SH
FIT	F IH T
FIVE	F AY V
FIX	F IH K S
FIXED	F IH K S T
FLAG	F L AE G
FLAT	F L AE T
FLEET	F L IY T
FLEXIBILITY	F L EH K S AH B IH L AH T IY
FLEXIBLE	F L EH K S AH B AH L
FLIGHT	F L AY T
FLIGHTS	F L AY T S
FLOATING	F L OW T IH NG
FLOOR	F L AO R
FLORIDA	F L AA R AH D AH
FLORIDA(2)	F L AA R IH D AH
FLORIDA(3)	F L AO R AH D AH
FLORIDA(4)	F L AO R IH D AH
FLOW	F L OW
FLOWN	F L OW N
FLY	F L AY
FLYING	F L AY IH NG
FOCUS	F OW K AH S
FOCUS(2)	F OW K IH S
FOCUSED	F OW K AH S T
FOCUSED(2)	F OW K IH S T
FOCUSING	F OW K AH S IH NG
FOCUSING(2)	F OW K IH S IH NG
FOLLOW	F AA L OW
FOLLOWED	F AA L OW D
FOLLOWING	F AA L OW IH NG
FOLLOWS	F AA L OW Z
FOOD	F UW D
FOODS	F UW D Z
FOOT	F UH T
FOOTBALL	F UH T B AO L
FOR	F AO R
FOR(2)	F ER
FOR(3)	F R ER
FORCE	F AO R S
FORCED	F AO R S T
FORCES	F AO R S IH Z
FORCING	F AO R S IH NG
FORD	F AO R D
FORD'S	F AO R D Z
FORECAST	F AO R K AE S T
FORECASTS	F AO R K AE S
FORECASTS(2)	F AO R K AE S S
FORECASTS(3)	F AO R K AE S T S
FOREIGN	F AA R AH N
FOREIGN(2)	F AO R AH N
FOREIGNERS	F AA R AH N ER Z
FOREIGNERS(2)	F AA R N ER Z
FOREIGNERS(3)	F AO R AH N ER Z
FOREIGNERS(4)	F AO R N ER Z
FOREST	F AO R AH S T
FOREST(2)	F AO R IH S T
FORGET	F AO R G EH T
FORGET(2)	F ER G EH T
FORM	F AO R M
FORMAL	F AO R M AH L
FORMALLY	F AO R M AH L IY
FORMED	F AO R M D
FORMER	F AO R M ER
FORMERLY	F AO R M ER L IY
FORMS	F AO R M Z
FORMULA	F AO R M Y AH L AH
FORT	F AO R T
FORTUNE	F AO R CH AH N
FORTUNE(2)	F AO R CH UW N
FORTY	F AO R T IY
FORWARD	F AO R W ER D
FOSTER	F AA S T ER
FOUGHT	F AO T
FOUND	F AW N D
FOUNDATION	F AW N D EY SH AH N
FOUNDED	F AW N D AH D
FOUNDED(2)	F AW N D IH D
FOUNDER	F AW N D ER
FOUR	F AO R
FOURTEEN	F AO R T IY N
FOURTEENTH	F AO R T IY N TH
FOURTH	F AO R TH
FOX	F AA K S
FRANCE	F R AE N S
FRANCE'S	F R AE N S IH Z
FRANCHISE	F R AE N CH AY Z
FRANCISCO	F R AE N S IH S K OW
FRANCS	F R AE NG K S
FRANK	F R AE NG K
FRANKFURT	F R AE NG K F ER T
FRANKLIN	F R AE NG K L IH N
FRAUD	F R AO D
FRED	F R EH D
FREDDIE	F R EH D IY
FREE	F R IY
FREEDOM	F R IY D AH M
FREEMAN	F R IY M AH N
FREEZE	F R IY Z
FREIGHT	F R EY T
FRENCH	F R EH N CH
FREQUENT	F R IY K W AH N T
FREQUENT(2)	F R IY K W EH N T
FREQUENTLY	F R IY K W AH N T L IY
FRESH	F R EH SH
FRIDAY	F R AY D EY
FRIDAY(2)	F R AY D IY
FRIDAY'S	F R AY D EY Z
FRIDAY'S(2)	F R AY D IY Z
FRIEND	F R EH N D
FRIENDLY	F R EH N D L IY
FRIENDLY(2)	F R EH N L IY
FRIENDS	F R EH N D Z
FRIENDS(2)	F R EH N Z
FROM	F ER M
FROM(2)	F R AH M
FRONT	F R AH N T
FROZEN	F R OW Z AH N
FRUIT	F R UW T
FUEL	F Y UW AH L
FUEL(2)	F Y UW L
FUELED	F Y UW AH L D
FULL	F UH L
FULLY	F UH L IY
FUN	F AH N
FUNCTION	F AH NG K SH AH N
FUNCTIONS	F AH NG K SH AH N Z
FUND	F AH N D
FUND'S	F AH N D Z
FUNDAMENTAL	F AH N D AH M EH N AH L
FUNDAMENTAL(2)	F AH N D AH M EH N T AH L
FUNDAMENTALS	F AH N D AH M EH N AH L Z
FUNDAMENTALS(2)	F AH N D AH M EH N T AH L Z
FUNDED	F AH N D AH D
FUNDED(2)	F AH N D IH D
FUNDING	F AH N D IH NG
FUNDS	F AH N D Z
FURNITURE	F ER N IH CH ER
FURTHER	F ER DH ER
FUTURE	F Y UW CH ER
FUTURES	F Y UW CH ER Z
G.	JH IY
GAIN	G EY N
GAINED	G EY N D
GAINERS	G EY N ER Z
GAINING	G EY N IH NG
GAINS	G EY N Z
GAMBLE	G AE M B AH L
GAMBLING	G AE M B AH L IH NG
GAMBLING(2)	G AE M B L IH NG
GAME	G EY M
GAMES	G EY M Z
GAP	G AE P
GARDEN	G AA R D AH N
GARY	G EH R IY
GAS	G AE S
GASOLINE	G AE S AH L IY N
GATES	G EY T S
GATHERING	G AE DH ER IH NG
GAVE	G EY V
GEAR	G IH R
GENE	JH IY N
GENENTECH	JH EH N AH N T EH K
GENERAL	JH EH N ER AH L
GENERAL(2)	JH EH N R AH L
GENERALE	JH EH N ER AE L
GENERALLY	JH EH N ER AH L IY
GENERALLY(2)	JH EH N R AH L IY
GENERATE	JH EH N ER EY T
GENERATED	JH EH N ER EY T AH D
GENERATED(2)	JH EH N ER EY T IH D
GENERATING	JH EH N ER EY T IH NG
GENERATION	JH EH N ER EY SH AH N
GENERIC	JH AH N EH R IH K
GENEROUS	JH EH N ER AH S
GENEVA	JH AH N IY V AH
GEORGE	JH AO R JH
GEORGIA	JH AO R JH AH
GEPHARDT	G EH P HH AA R T
GERALD	JH EH R AH L D
GERMAN	JH ER M AH N
GERMANS	JH ER M AH N Z
GERMANY	JH ER M AH N IY
GERMANY'S	JH ER M AH N IY Z
GET	G EH T
GET(2)	G IH T
GETS	G EH T S
GETS(2)	G IH T S
GETTING	G EH T IH NG
GETTING(2)	G IH T IH NG
GETTY	G EH T IY
GIANT	JH AY AH N T
GIANTS	JH AY AH N T S
GIFT	G IH F T
GILLETTE	JH IH L EH T
GIRL	G ER L
GIVE	G IH V
GIVEN	G IH V AH N
GIVEN(2)	G IH V IH N
GIVES	G IH V Z
GIVING	G IH V IH NG
GLASS	G L AE S
GLOBAL	G L OW B AH L
GO	G OW
GOAL	G OW L
GOALS	G OW L Z
GOD	G AA D
GOES	G OW Z
GOING	G OW IH N
GOING(2)	G OW IH NG
GOLD	G OW L D
GOLDEN	G OW L D AH N
GOLDMAN	G OW L D M AH N
GOLF	G AA L F
GOLF(2)	G AO L F
GONE	G AO N
GOOD	G IH D
GOOD(2)	G UH D
GOODS	G UH D Z
GOODYEAR	G UH D Y IH R
GOODYEAR(2)	G UH D Y IY R
GORBACHEV	G AO R B AH CH AO F
GORBACHEV(2)	G AO R B AH CH EH V
GORBACHEV'S	G AO R B AH CH AO F S
GORBACHEV'S(2)	G AO R B AH CH EH V Z
GORDON	G AO R D AH N
GOT	G AA T
GOTTEN	G AA T AH N
GOTTEN(2)	G AO T AH N
GOVERNMENT	G AH V ER M AH N T
GOVERNMENT(2)	G AH V ER N M AH N T
GOVERNMENT'S	G AH V ER M AH N T S
GOVERNMENT'S(2)	G AH V ER N M AH N T S
GOVERNMENTS	G AH V ER M AH N T S
GOVERNMENTS(2)	G AH V ER N M AH N T S
GOVERNOR	G AH V ER N ER
GOVERNORS	G AH V ER N ER Z
GRACE	G R EY S
GRADE	G R EY D
GRADUALLY	G R AE JH UW AH L IY
GRADUALLY(2)	G R AE JH UW L IY
GRADUATE	G R AE JH AH W AH T
GRADUATE(2)	G R AE JH AH W EY T
GRADUATE(3)	G R AE JH UW EY T
GRADUATE(4)	G R AE JH UW W AH T
GRAIN	G R EY N
GRAMM	G R AE M
GRAND	G R AE N D
GRANT	G R AE N T
GRANTED	G R AE N AH D
GRANTED(2)	G R AE N IH D
GRANTED(3)	G R AE N T AH D
GRANTED(4)	G R AE N T IH D
GRANTS	G R AE N T S
GRAPHICS	G R AE F IH K S
GRAY	G R EY
GREAT	G R EY T
GREATER	G R EY T ER
GREATEST	G R EY T AH S T
GREATLY	G R EY T L IY
GREEN	G R IY N
GREENSPAN	G R IY N S P AE N
GREW	G R UW
GROCERY	G R OW S ER IY
GROCERY(2)	G R OW S R IY
GROSS	G R OW S
GROUND	G R AW N D
GROUNDS	G R AW N D Z
GROUNDS(2)	G R AW N Z
GROUP	G R UW P
GROUP'S	G R UW P S
GROUPS	G R UW P S
GROW	G R OW
GROWING	G R OW IH NG
GROWN	G R OW N
GROWTH	G R OW TH
GUARANTEE	G EH R AH N T IY
GUARANTEED	G EH R AH N T IY D
GUARANTEES	G EH R AH N T IY Z
GUARANTY	G EH R AH N T IY
GUARD	G AA R D
GUESS	G EH S
GUIDE	G AY D
GUIDELINES	G AY D L AY N Z
GUILTY	G IH L T IY
GUINNESS	G IH N AH S
GULF	G AH L F
GUN	G AH N
GUY	G AY
GUYS	G AY Z
H.	EY CH
HAD	HH AE D
HADN'T	HH AE D AH N
HADN'T(2)	HH AE D AH N T
HAIR	HH EH R
HALF	HH AE F
HALL	HH AO L
HALT	HH AO L T
HALTED	HH AO L T AH D
HALTED(2)	HH AO L T IH D
HAMILTON	HH AE M AH L T AH N
HAMPSHIRE	HH AE M P SH AY ER
HAMPSHIRE(2)	HH AE M P SH ER
HAMPSHIRE(3)	HH AE M SH AY ER
HAMPSHIRE(4)	HH AE M SH ER
HAND	HH AE N D
HANDED	HH AE N D AH D
HANDED(2)	HH AE N D IH D
HANDFUL	HH AE N D F UH L
HANDLE	HH AE N D AH L
HANDLED	HH AE N D AH L D
HANDLING	HH AE N D AH L IH NG
HANDLING(2)	HH AE N D L IH NG
HANDS	HH AE N D Z
HANDS(2)	HH AE N Z
HANOVER	HH AE N OW V ER
HAPPEN	HH AE P AH N
HAPPENED	HH AE P AH N D
HAPPENING	HH AE P AH N IH NG
HAPPENING(2)	HH AE P N IH NG
HAPPENS	HH AE P AH N Z
HAPPY	HH AE P IY
HARD	HH AA R D
HARDER	HH AA R D ER
HARDLY	HH AA R D L IY
HARDWARE	HH AA R D W EH R
HAROLD	HH EH R AH L D
HARRIS	HH EH R IH S
HARRY	HH EH R IY
HART	HH AA R T
HARTFORD	HH AA R T F ER D
HARVARD	HH AA R V ER D
HARVEST	HH AA R V AH S T
HAS	HH AE Z
HAS(2)	HH AH Z
HASN'T	HH AE Z AH N T
HAVE	HH AE V
HAVEN'T	HH AE V AH N
HAVEN'T(2)	HH AE V AH N T
HAVING	HH AE V IH NG
HAZARDOUS	HH AE Z ER D AH S
HE	HH IY
HE'D	HH IY D
HE'LL	HH IY L
HE'S	HH IY Z
HEAD	HH EH D
HEADED	HH EH D AH D
HEADED(2)	HH EH D IH D
HEADING	HH EH D IH NG
HEADQUARTERS	HH EH D K AO R T ER Z
HEADQUARTERS(2)	HH EH D K W AO R T ER Z
HEADS	HH EH D Z
HEALTH	HH EH L TH
HEALTHY	HH EH L TH IY
HEAR	HH IH R
HEARD	HH ER D
HEARING	HH IH R IH NG
HEARINGS	HH IH R IH NG Z
HEART	HH AA R T
HEAT	HH IY T
HEATING	HH IY T IH NG
HEAVILY	HH EH V AH L IY
HEAVY	HH EH V IY
HEDGE	HH EH JH
HEFTY	HH EH F T IY
HELD	HH EH L D
HELICOPTER	HH EH L IH K AA P T ER
HELP	HH EH L P
HELPED	HH EH L P T
HELPING	HH EH L P IH NG
HELPS	HH EH L P S
HENLEY	HH EH N L IY
HENRY	HH EH N R IY
HER	HH ER
HERALD	HH EH R AH L D
HERE	HH IH R
HERITAGE	HH EH R AH T AH JH
HERITAGE(2)	HH EH R IH T IH JH
HEWLETT	HH Y UW L IH T
HIGH	HH AY
HIGHER	HH AY ER
HIGHEST	HH AY AH S T
HIGHLY	HH AY L IY
HIGHS	HH AY Z
HIGHWAY	HH AY W EY
HILL	HH IH L
HILLS	HH IH L Z
HILTON	HH IH L T AH N
HIM	HH IH M
HIM(2)	IH M
HIMSELF	HH IH M S EH L F
HIRE	HH AY ER
HIRE(2)	HH AY R
HIRED	HH AY ER D
HIRING	HH AY R IH NG
HIS	HH IH Z
HISTORIC	HH IH S T AO R IH K
HISTORICAL	HH IH S T AO R IH K AH L
HISTORY	HH IH S T ER IY
HISTORY(2)	HH IH S T R IY
HIT	HH IH T
HOLD	HH OW L D
HOLDER	HH OW L D ER
HOLDERS	HH OW L D ER Z
HOLDING	HH OW L D IH NG
HOLDINGS	HH OW L D IH NG Z
HOLDS	HH OW L D Z
HOLIDAY	HH AA L AH D EY
HOLIDAY(2)	HH AA L IH D EY
HOLLYWOOD	HH AA L IY W UH D
HOLMES	HH OW L M Z
HOLMES(2)	HH OW M Z
HOME	HH OW M
HOMES	HH OW M Z
HONDA	HH AO N D AH
HONG	HH AO NG
HONOR	AA N ER
HOPE	HH OW P
HOPED	HH OW P T
HOPES	HH OW P S
HOPING	HH OW P IH NG
HORSE	HH AO R S
HOSPITAL	HH AA S P IH T AH L
HOSPITALS	HH AA S P IH T AH L Z
HOST	HH OW S T
HOSTAGES	HH AA S T AH JH AH Z
HOSTILE	HH AA S T AH L
HOSTILE(2)	HH AA S T AY L
HOT	HH AA T
HOTEL	HH OW T EH L
HOTELS	HH OW T EH L Z
HOUR	AW ER
HOUR(2)	AW R
HOURLY	AW R L IY
HOURS	AW ER Z
HOURS(2)	AW R Z
HOUSE	HH AW S
HOUSEHOLD	HH AW S HH OW L D
HOUSEHOLDS	HH AW S HH OW L D Z
HOUSES	HH AW S AH Z
HOUSES(2)	HH AW S IH Z
HOUSING	HH AW Z IH NG
HOUSTON	HH Y UW S T AH N
HOW	HH AW
HOWARD	HH AW ER D
HOWEVER	HH AW EH V ER
HUD	HH AH D
HUDSON	HH AH D S AH N
HUGE	HH Y UW JH
HUGE(2)	Y UW JH
HUGHES	HH Y UW Z
HUGHES(2)	Y UW Z
HUMAN	HH Y UW M AH N
HUMAN(2)	Y UW M AH N
HUNDRED	HH AH N D ER D
HUNDRED(2)	HH AH N D R AH D
HUNDRED(3)	HH AH N D R IH D
HUNDRED(4)	HH AH N ER D
HUNDREDS	HH AH N D ER D Z
HUNDREDS(2)	HH AH N D R AH D Z
HUNDREDS(3)	HH AH N ER D Z
HUNT	HH AH N T
HUNTING	HH AH N T IH NG
HURT	HH ER T
HUSBAND	HH AH Z B AH N D
HUTTON	HH AH T AH N
I	AY
I'D	AY D
I'LL	AY L
I'M	AY M
I'VE	AY V
I.	AY
I.'S	AY Z
ICAHN	AY K AA N
ICE	AY S
IDEA	AY D IY AH
IDEAS	AY D IY AH Z
IDENTIFIED	AY D EH N AH F AY D
IDENTIFIED(2)	AY D EH N T AH F AY D
IDENTIFY	AY D EH N AH F AY
IDENTIFY(2)	AY D EH N T AH F AY
IDENTITY	AY D EH N AH T IY
IDENTITY(2)	AY D EH N IH T IY
IDENTITY(3)	AY D EH N T AH T IY
IDENTITY(4)	AY D EH N T IH T IY
IF	IH F
IGNORE	IH G N AO R
IGNORED	IH G N AO R D
ILL	IH L
ILLEGAL	IH L IY G AH L
ILLEGALLY	IH L IY G AH L IY
ILLINOIS	IH L AH N OY
ILLINOIS(2)	IH L AH N OY Z
IMAGE	IH M AH JH
IMAGE(2)	IH M IH JH
IMAGINE	IH M AE JH AH N
IMMEDIATE	IH M IY D IY AH T
IMMEDIATELY	IH M IY D IY AH T L IY
IMMIGRANTS	IH M AH G R AH N T S
IMMIGRATION	IH M AH G R EY SH AH N
IMMUNE	IH M Y UW N
IMPACT	IH M P AE K T
IMPERIAL	IH M P IH R IY AH L
IMPLICATIONS	IH M P L AH K EY SH AH N Z
IMPORT	IH M P AO R T
IMPORTANCE	IH M P AO R T AH N S
IMPORTANT	IH M P AO R T AH N T
IMPORTED	IH M P AO R T IH D
IMPORTS	IH M P AO R T S
IMPOSE	IH M P OW Z
IMPOSED	IH M P OW Z D
IMPOSSIBLE	IH M P AA S AH B AH L
IMPRESSION	IH M P R EH SH AH N
IMPRESSIVE	IH M P R EH S IH V
IMPROPER	IH M P R AA P ER
IMPROVE	IH M P R UW V
IMPROVED	IH M P R UW V D
IMPROVEMENT	IH M P R UW V M AH N T
IMPROVEMENTS	IH M P R UW V M AH N T S
IMPROVING	IH M P R UW V IH NG
IN	IH N
INADEQUATE	IH N AE D AH K W AH T
INADEQUATE(2)	IH N AE D AH K W EY T
INCENTIVE	IH N S EH N IH V
INCENTIVE(2)	IH N S EH N T IH V
INCENTIVES	IH N S EH N T IH V Z
INCENTIVES(2)	IH N S IH N IH V Z
INCH	IH N CH
INCIDENT	IH N S AH D AH N T
INCLUDE	IH N K L UW D
INCLUDED	IH N K L UW D AH D
INCLUDED(2)	IH N K L UW D IH D
INCLUDES	IH N K L UW D Z
INCLUDING	IH N K L UW D IH NG
INCOME	IH N K AH M
INCORPORATED	IH N K AO R P ER EY T AH D
INCORPORATED(2)	IH N K AO R P ER EY T IH D
INCORPORATED'S	IH N K AO R P ER EY T IH D Z
INCREASE	IH N K R IY S
INCREASED	IH N K R IY S T
INCREASES	IH N K R IY S AH Z
INCREASES(2)	IH N K R IY S IH Z
INCREASING	IH N K R IY S IH NG
INCREASINGLY	IH N K R IY S IH NG G L IY
INCREASINGLY(2)	IH N K R IY S IH NG L IY
INCURRED	IH N K ER D
INDEED	IH N D IY D
INDEPENDENCE	IH N D IH P EH N D AH N S
INDEPENDENT	IH N D IH P EH N D AH N T
INDEX	IH N D EH K S
INDEXES	IH N D EH K S IH Z
INDIA	IH N D IY AH
INDIAN	IH N D IY AH N
INDIANA	IH N D IY AE N AH
INDICATE	IH N D AH K EY T
INDICATED	IH N D AH K EY T AH D
INDICATED(2)	IH N D AH K EY T IH D
INDICATES	IH N D IH K EY T S
INDICATING	IH N D AH K EY T IH NG
INDICATION	IH N D AH K EY SH AH N
INDICATIONS	IH N D AH K EY SH AH N Z
INDICATOR	IH N D AH K EY T ER
INDICATORS	IH N D AH K EY T ER Z
INDICTED	IH N D AY T AH D
INDICTED(2)	IH N D AY T IH D
INDICTMENT	IH N D AY T M AH N T
INDIVIDUAL	IH N D AH V IH JH AH W AH L
INDIVIDUALS	IH N D AH V IH JH AH W AH L Z
INDUSTRIAL	IH N D AH S T R IY AH L
INDUSTRIALS	IH N D AH S T R IY AH L Z
INDUSTRIES	IH N D AH S T R IY Z
INDUSTRY	IH N D AH S T R IY
INDUSTRY'S	IH N D AH S T R IY Z
INEVITABLE	IH N EH V AH T AH B AH L
INFLATION	IH N F L EY SH AH N
INFLATIONARY	IH N F L EY SH AH N EH R IY
INFLUENCE	IH N F L UW AH N S
INFLUENTIAL	IH N F L UW EH N CH AH L
INFORMAL	IH N F AO R M AH L
INFORMATION	IH N F AO R M EY SH AH N
INFORMATION(2)	IH N F ER M EY SH AH N
INFORMED	IH N F AO R M D
INITIAL	IH N IH SH AH L
INITIALLY	IH N IH SH AH L IY
INITIATIVE	IH N IH SH AH T IH V
INITIATIVE(2)	IH N IH SH Y AH T IH V
INJUNCTION	IH N JH AH NG K SH AH N
INJUNCTION(2)	IH N JH AH NG SH AH N
INJURED	IH N JH ER D
INJURIES	IH N JH ER IY Z
INJURY	IH N JH ER IY
INQUIRY	IH N K W AY R IY
INQUIRY(2)	IH N K W ER R IY
INSIDE	IH N S AY D
INSIDER	IH N S AY D ER
INSIDERS	IH N S AY D ER Z
INSIST	IH N S IH S T
INSISTED	IH N S IH S T AH D
INSISTED(2)	IH N S IH S T IH D
INSISTS	IH N S IH S
INSISTS(2)	IH N S IH S S
INSISTS(3)	IH N S IH S T S
INSOLVENT	IH N S AA L V AH N T
INSPECTION	IH N S P EH K SH AH N
INSTALLED	IH N S T AO L D
INSTANCE	IH N S T AH N S
INSTEAD	IH N S T EH D
INSTITUTE	IH N S T AH T UW T
INSTITUTION	IH N S T IH T UW SH AH N
INSTITUTIONAL	IH N S T IH T UW SH AH N AH L
INSTITUTIONS	IH N S T IH T UW SH AH N Z
INSTRUMENT	IH N S T R AH M AH N T
INSTRUMENTS	IH N S T R AH M AH N T S
INSURANCE	IH N SH UH R AH N S
INSURED	IH N SH UH R D
INSURER	IH N SH UH R ER
INSURERS	IH N SH UH R ER Z
INTEGRATED	IH N AH G R EY T AH D
INTEGRATED(2)	IH N AH G R EY T IH D
INTEGRATED(3)	IH N T AH G R EY T AH D
INTEGRATED(4)	IH N T AH G R EY T IH D
INTEL	IH N T EH L
INTELLECTUAL	IH N AH L EH K CH UW AH L
INTELLECTUAL(2)	IH N T AH L EH K CH UW AH L
INTELLIGENCE	IH N T EH L AH JH AH N S
INTEND	IH N T EH N D
INTENDED	IH N T EH N D AH D
INTENDED(2)	IH N T EH N D IH D
INTENDS	IH N T EH N D Z
INTENSE	IH N T EH N S
INTENT	IH N T EH N T
INTENTION	IH N T EH N CH AH N
INTENTIONS	IH N T EH N CH AH N Z
INTERBANK	IH N T ER B AE NG K
INTEREST	IH N T ER AH S T
INTEREST(2)	IH N T ER IH S T
INTEREST(3)	IH N T R AH S T
INTEREST(4)	IH N T R IH S T
INTERESTED	IH N T ER AH S T AH D
INTERESTED(2)	IH N T ER IH S T IH D
INTERESTED(3)	IH N T R AH S T AH D
INTERESTED(4)	IH N T R IH S T IH D
INTERESTING	IH N T ER AH S T IH NG
INTERESTING(2)	IH N T ER IH S T IH NG
INTERESTING(3)	IH N T R AH S T IH NG
INTERESTING(4)	IH N T R IH S T IH NG
INTERESTS	IH N T ER AH S T S
INTERESTS(2)	IH N T ER IH S S
INTERESTS(3)	IH N T ER IH S T S
INTERESTS(4)	IH N T R AH S T S
INTERESTS(5)	IH N T R IH S S
INTERESTS(6)	IH N T R IH S T S
INTERIM	IH N ER AH M
INTERIM(2)	IH N T ER AH M
INTERIM(3)	IH N T R AH M
INTERIOR	IH N T IH R IY ER
INTERMEDIATE	IH N ER M IY D IY IH T
INTERMEDIATE(2)	IH N T ER M IY D IY IH T
INTERNAL	IH N T ER N AH L
INTERNATIONAL	IH N ER N AE SH AH N AH L
INTERNATIONAL(2)	IH N T ER N AE SH AH N AH L
INTERPRETATION	IH N T ER P R IH T EY SH AH N
INTERSTATE	IH N ER S T EY T
INTERSTATE(2)	IH N T ER S T EY T
INTERVENTION	IH N ER V EH N CH AH N
INTERVENTION(2)	IH N T ER V EH N CH AH N
INTERVIEW	IH N ER V Y UW
INTERVIEW(2)	IH N T ER V Y UW
INTERVIEWED	IH N ER V Y UW D
INTERVIEWED(2)	IH N T ER V Y UW D
INTERVIEWS	IH N ER V Y UW Z
INTERVIEWS(2)	IH N T ER V Y UW Z
INTO	IH N T AH
INTO(2)	IH N T UW
INTRODUCE	IH N T R AH D UW S
INTRODUCE(2)	IH N T R OW D UW S
INTRODUCED	IH N T R AH D UW S T
INTRODUCED(2)	IH N T R OW D UW S T
INTRODUCTION	IH N T R AH D AH K SH AH N
INTRODUCTION(2)	IH N T R OW D AH K SH AH N
INVENTORIES	IH N V AH N T AO R IY Z
INVENTORY	IH N V AH N T AO R IY
INVEST	IH N V EH S T
INVESTED	IH N V EH S T AH D
INVESTED(2)	IH N V EH S T IH D
INVESTIGATE	IH N V EH S T AH G EY T
INVESTIGATING	IH N V EH S T AH G EY T IH NG
INVESTIGATION	IH N V EH S T AH G EY SH AH N
INVESTIGATIONS	IH N V EH S T AH G EY SH AH N Z
INVESTIGATORS	IH N V EH S T AH G EY T ER Z
INVESTING	IH N V EH S T IH NG
INVESTMENT	IH N V EH S M AH N T
INVESTMENT(2)	IH N V EH S T M AH N T
INVESTMENTS	IH N V EH S M AH N T S
INVESTMENTS(2)	IH N V EH S T M AH N T S
INVESTOR	IH N V EH S T ER
INVESTORS	IH N V EH S T ER Z
INVESTORS'	IH N V EH S T ER Z
INVITED	IH N V AY T AH D
INVITED(2)	IH N V AY T IH D
INVOLVE	IH N V AA L V
INVOLVED	IH N V AA L V D
INVOLVEMENT	IH N V AA L V M AH N T
INVOLVES	IH N V AA L V Z
INVOLVING	IH N V AA L V IH NG
IOWA	AY AH W AH
IOWA(2)	AY OW AH
IRAN	AY R AE N
IRAN(2)	IH R AA N
IRAN'S	AY R AE N Z
IRAN'S(2)	IH R AE N Z
IRANIAN	AY R EY N IY AH N
IRANIAN(2)	IH R AA N IY AH N
IRAQ	AY R AA K
IRAQ(2)	IH R AA K
IRAQ(3)	IY R AA K
IRAQI	AY R AE K IY
IRAQI(2)	IH R AE K IY
IRAQI(3)	IY R AE K IY
IRISH	AY R IH SH
IRON	AY ER N
IRVING	ER V IH NG
IS	IH Z
ISLAND	AY L AH N D
ISN'T	IH Z AH N
ISN'T(2)	IH Z AH N T
ISRAEL	IH Z R EY L
ISRAEL(2)	IH Z R IY AH L
ISRAELI	IH Z R EY L IY
ISSUE	IH SH UW
ISSUED	IH SH UW D
ISSUES	IH SH UW Z
ISSUING	IH SH UW IH NG
IT	IH T
IT'S	IH T S
ITALIAN	IH T AE L Y AH N
ITALY	IH T AH L IY
ITEM	AY T AH M
ITEMS	AY T AH M Z
ITS	IH T S
ITSELF	IH T S EH L F
IVAN	AY V AH N
J.	JH EY
JACK	JH AE K
JACKSON	JH AE K S AH N
JACOBS	JH EY K AH B Z
JAIL	JH EY L
JAMES	JH EY M Z
JANUARY	JH AE N Y UW EH R IY
JAPAN	JH AH P AE N
JAPAN'S	JH AH P AE N Z
JAPANESE	JH AE P AH N IY Z
JEFFERIES	JH EH F R IY Z
JEFFREY	JH EH F R IY
JERRY	JH EH R IY
JERSEY	JH ER Z IY
JESSE	JH EH S IY
JET	JH EH T
JETS	JH EH T S
JEWISH	JH UW IH SH
JIM	JH IH M
JOB	JH AA B
JOB(2)	JH OW B
JOBS	JH AA B Z
JOE	JH OW
JOHN	JH AA N
JOHNSON	JH AA N S AH N
JOIN	JH OY N
JOINED	JH OY N D
JOINING	JH OY N IH NG
JOINT	JH OY N T
JOINTLY	JH OY N T L IY
JONES	JH OW N Z
JORDAN	JH AO R D AH N
JOSE	HH OW Z EY
JOSEPH	JH OW S AH F
JOSEPH(2)	JH OW Z AH F
JOURNAL	JH ER N AH L
JOURNAL'S	JH ER N AH L Z
JOURNALISTS	JH ER N AH L AH S T S
JOURNALISTS(2)	JH ER N AH L IH S
JOURNALISTS(3)	JH ER N AH L IH S S
JOURNALISTS(4)	JH ER N AH L IH S T S
JUDGE	JH AH JH
JUDGES	JH AH JH IH Z
JUDGMENT	JH AH JH M AH N T
JUDICIAL	JH UW D IH SH AH L
JULY	JH AH L AY
JULY(2)	JH UW L AY
JUMP	JH AH M P
JUMPED	JH AH M P T
JUNE	JH UW N
JUNIOR	JH UW N Y ER
JUNK	JH AH NG K
JURY	JH UH R IY
JUST	JH AH S T
JUST(2)	JH IH S T
JUSTICE	JH AH S T AH S
JUSTICE(2)	JH AH S T IH S
JUSTICES	JH AH S T AH S AH Z
JUSTICES(2)	JH AH S T IH S IH Z
JUSTIFY	JH AH S T AH F AY
K.	K EY
KANSAS	K AE N Z AH S
KEEP	K IY P
KEEPING	K IY P IH NG
KEEPS	K IY P S
KEMP	K EH M P
KENNEDY	K EH N AH D IY
KENNETH	K EH N IH TH
KENTUCKY	K AH N T AH K IY
KEPT	K AE P T
KEPT(2)	K EH P T
KEY	K IY
KIDDER	K IH D ER
KIDS	K IH D Z
KILL	K IH L
KILLED	K IH L D
KILLING	K IH L IH NG
KIM	K IH M
KIND	K AY N D
KINDS	K AY N D Z
KINDS(2)	K AY N Z
KING	K IH NG
KINGDOM	K IH NG D AH M
KNEW	N UW
KNEW(2)	N Y UW
KNIGHT	N AY T
KNOW	N OW
KNOWLEDGE	N AA L AH JH
KNOWLEDGE(2)	N AA L IH JH
KNOWN	N OW N
KNOWS	N OW Z
KODAK	K OW D AE K
KOHLBERG	K OW L B ER G
KONG	K AO NG
KONG(2)	K AO NG G
KOREA	K AO R IY AH
KOREA(2)	K ER R IY AH
KOREA(3)	K R IY AH
KOREA'S	K AO R IY AH Z
KOREA'S(2)	K ER R IY AH Z
KOREA'S(3)	K R IY AH Z
KOREAN	K AO R IY AH N
KOREAN(2)	K ER R IY AH N
KOREAN(3)	K R IY AH N
KRAFT	K R AE F T
KRAVIS	K R AE V IH S
KUWAIT	K UW W EY T
L.	EH L
LA	L AA
LAB	L AE B
LABEL	L EY B AH L
LABOR	L EY B ER
LABORATORIES	L AE B R AH T AO R IY Z
LABORATORY	L AE B R AH T AO R IY
LACK	L AE K
LAID	L EY D
LAKE	L EY K
LAMBERT	L AE M B ER T
LAND	L AE N D
LANDING	L AE N D IH NG
LANGUAGE	L AE NG G W AH JH
LANGUAGE(2)	L AE NG G W IH JH
LARGE	L AA R JH
LARGELY	L AA R JH L IY
LARGER	L AA R JH ER
LARGEST	L AA R JH AH S T
LARRY	L EH R IY
LAS	EH L EY EH S
LAS(2)	L AA S
LASER	L EY Z ER
LAST	L AE S
LAST(2)	L AE S T
LAST(3)	L AO S T
LATE	L EY T
LATELY	L EY T L IY
LATER	L EY T ER
LATEST	L EY T AH S T
LATIN	L AE T AH N
LATTER	L AE T ER
LAUNCH	L AO N CH
LAUNCHED	L AO N CH T
LAUNCHING	L AO N CH IH NG
LAW	L AA
LAW(2)	L AO
LAWMAKERS	L AO M EY K ER Z
LAWRENCE	L AO R AH N S
LAWS	L AO Z
LAWSON	L AO S AH N
LAWSUIT	L AO S UW T
LAWSUITS	L AO S UW T S
LAWYER	L AO Y ER
LAWYER(2)	L OY ER
LAWYERS	L AO Y ER Z
LAWYERS(2)	L OY ER Z
LAY	L EY
LAYOFFS	L EY AO F S
LEAD	L EH D
LEAD(2)	L IY D
LEADER	L IY D ER
LEADERS	L IY D ER Z
LEADERSHIP	L IY D ER SH IH P
LEADING	L IY D IH NG
LEADS	L IY D Z
LEAGUE	L IY G
LEARN	L ER N
LEARNED	L ER N D
LEARNED(2)	L ER N IH D
LEARNING	L ER N IH NG
LEASE	L IY S
LEASES	L IY S IH Z
LEASING	L IY S IH NG
LEAST	L IY S T
LEAVE	L IY V
LEAVES	L IY V Z
LEAVING	L IY V IH NG
LEBANON	L EH B AH N AH N
LED	L EH D
LEE	L IY
LEFT	L EH F T
LEGAL	L IY G AH L
LEGISLATION	L EH JH AH S L EY SH AH N
LEGISLATIVE	L EH JH AH S L EY T IH V
LEGISLATORS	L EH JH AH S L EY T ER Z
LEGISLATURE	L EH JH AH S L EY CH ER
LEGITIMATE	L AH JH IH T AH M AH T
LEHMAN	L IY M AH N
LEND	L EH N D
LENDER	L EH N D ER
LENDERS	L EH N D ER Z
LENDING	L EH N D IH NG
LENGTH	L EH NG K TH
LENGTH(2)	L EH NG TH
LENGTHY	L EH NG TH IY
LEONARD	L EH N ER D
LESS	L EH S
LET	L EH T
LET'S	L EH T S
LETTER	L EH T ER
LETTERS	L EH T ER Z
LETTING	L EH T IH NG
LEVEL	L EH V AH L
LEVELS	L EH V AH L Z
LEVERAGE	L EH V ER IH JH
LEVERAGE(2)	L EH V R AH JH
LEVERAGE(3)	L IY V ER IH JH
LEVERAGED	L EH V ER IH JH D
LEVERAGED(2)	L EH V R IH JH D
LEVERAGED(3)	L IY V ER IH JH D
LEVINE	L AH V IY N
LEVY	L EH V IY
LEVY(2)	L IY V IY
LEWIS	L UW IH S
LIABILITIES	L AY AH B IH L AH T IY Z
LIABILITIES(2)	L AY AH B IH L IH T IY Z
LIABILITY	L AY AH B IH L IH T IY
LIBERAL	L IH B ER AH L
LIBERAL(2)	L IH B R AH L
LIBERALS	L IH B ER AH L Z
LIBERALS(2)	L IH B R AH L Z
LIBERTY	L IH B ER T IY
LIBRARY	L AY B R EH R IY
LICENSE	L AY S AH N S
LICENSES	L AY S AH N S IH Z
LICENSING	L AY S AH N S IH NG
LIE	L AY
LIES	L AY Z
LIEUTENANT	L UW T EH N AH N T
LIFE	L AY F
LIFT	L IH F T
LIFTED	L IH F T AH D
LIFTED(2)	L IH F T IH D
LIGHT	L AY T
LIKE	L AY K
LIKELY	L AY K L IY
LIKES	L AY K S
LIMIT	L IH M AH T
LIMITED	L IH M AH T AH D
LIMITED(2)	L IH M IH T IH D
LIMITING	L IH M AH T IH NG
LIMITS	L IH M AH T S
LIMITS(2)	L IH M IH T S
LINCOLN	L IH NG K AH N
LINE	L AY N
LINES	L AY N Z
LINK	L IH NG K
LINKED	L IH NG K T
LIQUID	L IH K W AH D
LIQUID(2)	L IH K W IH D
LIQUIDATION	L IH K W IH D EY SH AH N
LIQUIDITY	L IH K W IH D AH T IY
LIQUIDITY(2)	L IH K W IH D IH T IY
LIQUOR	L IH K ER
LIRE	L IH R AH
LIST	L IH S T
LISTED	L IH S T AH D
LISTED(2)	L IH S T IH D
LISTING	L IH S T IH NG
LISTS	L IH S
LISTS(2)	L IH S S
LISTS(3)	L IH S T S
LITIGATION	L IH T AH G EY SH AH N
LITTLE	L IH T AH L
LIVE	L AY V
LIVE(2)	L IH V
LIVED	L AY V D
LIVED(2)	L IH V D
LIVES	L AY V Z
LIVES(2)	L IH V Z
LIVING	L IH V IH NG
LLOYD	L OY D
LOAD	L OW D
LOAN	L OW N
LOANS	L OW N Z
LOBBY	L AA B IY
LOBBYING	L AA B IY IH NG
LOCAL	L OW K AH L
LOCATED	L OW K EY D
LOCATED(2)	L OW K EY T AH D
LOCATION	L OW K EY SH AH N
LOCKHEED	L AA K HH IY D
LONDON	L AH N D AH N
LONDON'S	L AH N D AH N Z
LONG	L AO NG
LONGER	L AO NG G ER
LONGTIME	L AO NG T AY M
LOOK	L UH K
LOOKED	L UH K T
LOOKING	L UH K IH NG
LOOKS	L UH K S
LORD	L AO R D
LORIMAR	L AO R AH M AA R
LOS	L AO S
LOS(2)	L OW S
LOSE	L UW Z
LOSING	L UW Z IH NG
LOSS	L AO S
LOSSES	L AO S AH Z
LOSSES(2)	L AO S IH Z
LOST	L AO S T
LOT	L AA T
LOT(2)	L AO T
LOTS	L AA T S
LOTUS	L OW T AH S
LOUIS	L UW IH S
LOUIS(2)	L UW IY
LOUISIANA	L UW IY Z IY AE N AH
LOVE	L AH V
LOW	L OW
LOWER	L OW ER
LOWERED	L OW ER D
LOWERING	L OW ER IH NG
LOWEST	L OW AH S T
LOWS	L OW Z
LOYALTY	L OY AH L T IY
LUCKY	L AH K IY
LUCRATIVE	L UW K R AH T IH V
LUFKIN	L AH F K IH N
LUNCH	L AH N CH
LUXURY	L AH G ZH ER IY
LYNCH	L IH N CH
M.	EH M
M.'S	EH M Z
MAC	M AE K
MACHINE	M AH SH IY N
MACHINERY	M AH SH IY N ER IY
MACHINERY(2)	M AH SH IY N R IY
MACHINES	M AH SH IY N Z
MACMILLAN	M AH K M IH L AH N
MADE	M EY D
MAE	M EY
MAGAZINE	M AE G AH Z IY N
MAGAZINES	M AE G AH Z IY N Z
MAIL	M EY L
MAIN	M EY N
MAINE	M EY N
MAINLY	M EY N L IY
MAINTAIN	M EY N T EY N
MAINTAINED	M EY N T EY N D
MAINTAINING	M EY N T EY N IH NG
MAINTAINS	M EY N T EY N Z
MAINTENANCE	M EY N T AH N AH N S
MAINTENANCE(2)	M EY N T N AH N S
MAJOR	M EY JH ER
MAJORITY	M AH JH AO R AH T IY
MAKE	M EY K
MAKER	M EY K ER
MAKER'S	M EY K ER Z
MAKERS	M EY K ER Z
MAKES	M EY K S
MAKING	M EY K IH NG
MALE	M EY L
MAN	M AE N
MANAGE	M AE N AH JH
MANAGE(2)	M AE N IH JH
MANAGED	M AE N AH JH D
MANAGED(2)	M AE N IH JH D
MANAGEMENT	M AE N AH JH M AH N T
MANAGEMENT(2)	M AE N IH JH M AH N T
MANAGER	M AE N AH JH ER
MANAGER(2)	M AE N IH JH ER
MANAGERS	M AE N AH JH ER Z
MANAGERS(2)	M AE N IH JH ER Z
MANAGES	M AE N IH JH IH Z
MANAGING	M AE N AH JH IH NG
MANDATORY	M AE N D AH T AO R IY
MANHATTAN	M AE N HH AE T AH N
MANILA	M AH N IH L AH
MANNER	M AE N ER
MANUFACTURED	M AE N Y AH F AE K CH ER D
MANUFACTURER	M AE N Y AH F AE K CH ER ER
MANUFACTURERS	M AE N Y AH F AE K CH ER ER Z
MANUFACTURING	M AE N Y AH F AE K CH ER IH NG
MANY	M EH N IY
MARCH	M AA R CH
MARCOS	M AA R K OW S
MARGIN	M AA R JH AH N
MARGINAL	M AA R JH AH N AH L
MARGINS	M AA R JH AH N Z
MARINE	M ER IY N
MARK	M AA R K
MARKED	M AA R K T
MARKET	M AA R K AH T
MARKET(2)	M AA R K IH T
MARKET'S	M AA R K AH T S
MARKETING	M AA R K AH T IH NG
MARKETPLACE	M AA R K AH T P L EY S
MARKETPLACE(2)	M AA R K IH T P L EY S
MARKETS	M AA R K AH T S
MARKETS(2)	M AA R K IH T S
MARKS	M AA R K S
MARRIAGE	M EH R IH JH
MARRIED	M EH R IY D
MARSHALL	M AA R SH AH L
MART	M AA R T
MARTIN	M AA R T AH N
MARTIN(2)	M AA R T IH N
MARY	M EH R IY
MARYLAND	M EH R AH L AH N D
MASS	M AE S
MASSACHUSETTS	M AE S AH CH UW S AH T S
MASSIVE	M AE S IH V
MASTER	M AE S T ER
MATCH	M AE CH
MATERIAL	M AH T IH R IY AH L
MATERIALS	M AH T IH R IY AH L Z
MATTER	M AE T ER
MATTERS	M AE T ER Z
MATURE	M AH CH UH R
MATURE(2)	M AH T Y UH R
MATURITY	M AH CH UH R AH T IY
MATURITY(2)	M AH T Y UH R IH T IY
MAXIMUM	M AE K S AH M AH M
MAXWELL	M AE K S W EH L
MAY	M EY
MAYBE	M EY B IY
MAYOR	M EY ER
MCDONALD'S	M AH K D AA N AH L D Z
MCDONNELL	M AH K D AA N AH L
ME	M IY
MEAN	M IY N
MEANING	M IY N IH NG
MEANS	M IY N Z
MEANT	M EH N T
MEANTIME	M IY N T AY M
MEANWHILE	M IY N W AY L
MEASURE	M EH ZH ER
MEASURED	M EH ZH ER D
MEASURES	M EH ZH ER Z
MEAT	M IY T
MEDIA	M IY D IY AH
MEDICAL	M EH D AH K AH L
MEDICAL(2)	M EH D IH K AH L
MEDICARE	M EH D AH K EH R
MEDICINE	M EH D AH S AH N
MEDIUM	M IY D IY AH M
MEESE	M IY S
MEET	M IY T
MEETING	M IY T IH NG
MEETINGS	M IY T IH NG Z
MELLON	M EH L AH N
MEMBER	M EH M B ER
MEMBERS	M EH M B ER Z
MEMBERSHIP	M EH M B ER SH IH P
MEMO	M EH M OW
MEMORIES	M EH M ER IY Z
MEMORY	M EH M ER IY
MEN	M EH N
MENTION	M EH N SH AH N
MENTIONED	M EH N SH AH N D
MERC	M AA R K
MERC(2)	M ER K
MERCANTILE	M ER K AH N T AY L
MERCHANDISE	M ER CH AH N D AY Z
MERCHANT	M ER CH AH N T
MERE	M IH R
MERELY	M IH R L IY
MERGE	M ER JH
MERGED	M ER JH D
MERGER	M ER JH ER
MERGERS	M ER JH ER Z
MERIT	M EH R AH T
MERRILL	M EH R AH L
MESA	M EY S AH
MESSAGE	M EH S AH JH
MESSAGE(2)	M EH S IH JH
MESSRS.	M EH S ER Z
MESSRS.(2)	M IH S UW R Z
MET	M EH T
METAL	M EH T AH L
METALS	M EH T AH L Z
METHOD	M EH TH AH D
METHODS	M EH TH AH D Z
METRIC	M EH T R IH K
METROPOLITAN	M EH T R AH P AA L AH T AH N
MEXICAN	M EH K S AH K AH N
MEXICO	M EH K S AH K OW
MEXICO'S	M EH K S AH K OW Z
MIAMI	M AY AE M IY
MICHAEL	M AY K AH L
MICHIGAN	M IH SH IH G AH N
MICROSOFT	M AY K R OW S AO F T
MID	M IH D
MIDDLE	M IH D AH L
MIDLAND	M IH D L AE N D
MIDWEST	M IH D W EH S T
MIGHT	M AY T
MIKHAIL	M IH K AY L
MIKHAIL(2)	M IH K EY L
MILAN	M AH L AA N
MILAN(2)	M AY L AE N
MILAN(3)	M IH L AA N
MILE	M AY L
MILES	M AY AH L Z
MILES(2)	M AY L Z
MILITARY	M IH L AH T EH R IY
MILITARY(2)	M IH L IH T EH R IY
MILK	M IH L K
MILKEN	M IH L K AH N
MILL	M IH L
MILLER	M IH L ER
MILLION	M IH L Y AH N
MILLIONS	M IH L Y AH N Z
MILLS	M IH L Z
MIND	M AY N D
MINDS	M AY N D Z
MINE	M AY N
MINERALS	M IH N ER AH L Z
MINERALS(2)	M IH N R AH L Z
MINES	M AY N Z
MINIMUM	M IH N AH M AH M
MINING	M AY N IH NG
MINISTER	M IH N AH S T ER
MINISTER(2)	M IH N IH S T ER
MINISTERS	M IH N AH S T ER Z
MINISTERS(2)	M IH N IH S T ER Z
MINISTRY	M IH N AH S T R IY
MINISTRY(2)	M IH N IH S T R IY
MINNEAPOLIS	M IH N IY AE P AH L IH S
MINNESOTA	M IH N IH S OW T AH
MINOR	M AY N ER
MINORITY	M AH N AO R AH T IY
MINORITY(2)	M AY N AO R AH T IY
MINUS	M AY N AH S
MINUTE	M AY N UW T
MINUTE(2)	M AY N Y UW T
MINUTE(3)	M IH N AH T
MINUTES	M IH N AH T S
MIRROR	M IH R ER
MISLEADING	M IH S L IY D IH NG
MISS	M IH S
MISSED	M IH S T
MISSILE	M IH S AH L
MISSILES	M IH S AH L Z
MISSING	M IH S IH NG
MISSION	M IH SH AH N
MISSISSIPPI	M IH S IH S IH P IY
MISSOURI	M AH Z ER AH
MISSOURI(2)	M AH Z UH R IY
MISTAKE	M IH S T EY K
MISTAKES	M IH S T EY K S
MITCHELL	M IH CH AH L
MITSUBISHI	M IH T S UW B IY SH IY
MIX	M IH K S
MIXED	M IH K S T
MOBIL	M OW B AH L
MOBILE	M OW B AH L
MODEL	M AA D AH L
MODELS	M AA D AH L Z
MODERATE	M AA D ER AH T
MODERATE(2)	M AA D ER EY T
MODERN	M AA D ER N
MODEST	M AA D AH S T
MOMENT	M OW M AH N T
MOMENTUM	M OW M EH N T AH M
MONDAY	M AH N D EY
MONDAY(2)	M AH N D IY
MONDAY'S	M AH N D EY Z
MONDAY'S(2)	M AH N D IY Z
MONETARY	M AA N AH T EH R IY
MONEY	M AH N IY
MONITOR	M AA N AH T ER
MONITORING	M AA N AH T ER IH NG
MONOPOLY	M AH N AA P AH L IY
MONTGOMERY	M AA N T G AH M R IY
MONTH	M AH N TH
MONTH'S	M AH N TH S
MONTHLY	M AH N TH L IY
MONTHS	M AH N TH S
MONTREAL	M AH N T R IY AO L
MOOD	M UW D
MOODY'S	M UW D IY Z
MOORE	M AO R
MOORE(2)	M UH R
MORAL	M AO R AH L
MORE	M AO R
MOREOVER	M AO R OW V ER
MORGAN	M AO R G AH N
MORNING	M AO R N IH NG
MORRIS	M AO R AH S
MORRIS(2)	M AO R IH S
MORTGAGE	M AO R G AH JH
MORTGAGE(2)	M AO R G IH JH
MORTGAGES	M AO R G AH JH AH Z
MORTGAGES(2)	M AO R G IH JH IH Z
MOSCOW	M AA S K OW
MOSCOW(2)	M AO S K AW
MOST	M OW S
MOST(2)	M OW S T
MOSTLY	M OW S L IY
MOSTLY(2)	M OW S T L IY
MOTHER	M AH DH ER
MOTION	M OW SH AH N
MOTOR	M OW T ER
MOTORS	M OW T ER Z
MOUNT	M AW N T
MOUNTAIN	M AW N T AH N
MOUNTING	M AW N T IH NG
MOVE	M UW V
MOVED	M UW V D
MOVEMENT	M UW V M AH N T
MOVEMENTS	M UW V M AH N T S
MOVES	M UW V Z
MOVIE	M UW V IY
MOVIES	M UW V IY Z
MOVING	M UW V IH NG
MR.	M IH S T ER
MRS.	M IH S IH Z
MS.	M IH Z
MUCH	M AH CH
MULTIPLE	M AH L T AH P AH L
MUNICIPAL	M Y UW N IH S AH P AH L
MURDER	M ER D ER
MURDOCH	M ER D AA K
MURPHY	M ER F IY
MURRAY	M AH R IY
MURRAY(2)	M ER IY
MUSEUM	M Y UW Z IY AH M
MUSIC	M Y UW Z IH K
MUST	M AH S T
MUTUAL	M Y UW CH AH W AH L
MY	M AY
MYERS	M AY ER Z
MYSELF	M AY S EH L F
N.	EH N
NABISCO	N AH B IH S K OW
NAME	N EY M
NAMED	N EY M D
NAMES	N EY M Z
NARROW	N AE R OW
NARROW(2)	N EH R OW
NARROWED	N EH R OW D
NASDAQ	N AE Z D AE K
NATION	N EY SH AH N
NATION'S	N EY SH AH N Z
NATIONAL	N AE SH AH N AH L
NATIONAL(2)	N AE SH N AH L
NATIONS	N EY SH AH N Z
NATIONWIDE	N EY SH AH N W AY D
NATIVE	N EY T IH V
NATO	N EY T OW
NATURAL	N AE CH ER AH L
NATURAL(2)	N AE CH R AH L
NATURE	N EY CH ER
NAVAL	N EY V AH L
NAVY	N EY V IY
NEAR	N IH R
NEARBY	N IH R B AY
NEARLY	N IH R L IY
NECESSARILY	N EH S AH S EH R AH L IY
NECESSARY	N EH S AH S EH R IY
NEED	N IY D
NEEDED	N IY D AH D
NEEDED(2)	N IY D IH D
NEEDS	N IY D Z
NEGATIVE	N EH G AH T IH V
NEGOTIATE	N AH G OW SH IY EY T
NEGOTIATE(2)	N IH G OW SH IY EY T
NEGOTIATED	N AH G OW SH IY EY T AH D
NEGOTIATED(2)	N IH G OW SH IY EY T IH D
NEGOTIATING	N IH G OW SH IY EY T IH NG
NEGOTIATIONS	N AH G OW SH IY EY SH AH N Z
NEGOTIATIONS(2)	N IH G OW SH IY EY SH AH N Z
NEGOTIATORS	N IH G OW SH IY EY T ER Z
NEIGHBORHOOD	N EY B ER HH UH D
NEITHER	N AY DH ER
NEITHER(2)	N IY DH ER
NELSON	N EH L S AH N
NERVOUS	N ER V AH S
NET	N EH T
NETHERLANDS	N EH DH ER L AH N D Z
NETWORK	N EH T W ER K
NETWORKS	N EH T W ER K S
NEVADA	N AH V AA D AH
NEVADA(2)	N AH V AE D AH
NEVER	N EH V ER
NEVERTHELESS	N EH V ER DH AH L EH S
NEW	N UW
NEW(2)	N Y UW
NEWLY	N UW L IY
NEWMONT	N UW M AA N T
NEWPORT	N UW P AO R T
NEWS	N UW Z
NEWS(2)	N Y UW Z
NEWSLETTER	N UW Z L EH T ER
NEWSPAPER	N UW Z P EY P ER
NEWSPAPERS	N UW Z P EY P ER Z
NEWSPRINT	N UW Z P R IH N T
NEXT	N EH K S
NEXT(2)	N EH K S T
NICARAGUA	N IH K ER AA G W AH
NICARAGUAN	N IH K ER AA G W AH N
NICE	N AY S
NICE(2)	N IY S
NIGHT	N AY T
NIKKEI	N AY K IY
NIKKEI(2)	N IH K EY
NIKKEI(3)	N IY K EY
NINE	N AY N
NINETEEN	N AY N T IY N
NINETEENTH	N AY N T IY N TH
NINETIES	N AY N T IY Z
NINETY	N AY N T IY
NINTH	N AY N TH
NIPPON	N IH P AA N
NISSAN	N IY S AA N
NIXON	N IH K S AH N
NO	N OW
NOBODY	N OW B AA D IY
NOBODY(2)	N OW B AH D IY
NOMINATION	N AA M AH N EY SH AH N
NOMINEE	N AA M AH N IY
NOMURA	N OW M UH R AH
NON	N AA N
NONE	N AH N
NONETHELESS	N AH N DH AH L EH S
NONPROFIT	N AA N P R AA F AH T
NOR	N AO R
NORIEGA	N AO R IY EY G AH
NORMAL	N AO R M AH L
NORMALLY	N AO R M AH L IY
NORMALLY(2)	N AO R M L IY
NORMAN	N AO R M AH N
NORTH	N AO R TH
NORTHEAST	N AO R TH IY S T
NORTHERN	N AO R DH ER N
NORTHROP	N AO R TH R AH P
NORTHWEST	N AO R TH W EH S T
NOT	N AA T
NOTE	N OW T
NOTED	N OW T AH D
NOTED(2)	N OW T IH D
NOTES	N OW T S
NOTHING	N AH TH IH NG
NOTICE	N OW T AH S
NOTICE(2)	N OW T IH S
NOTING	N OW T IH NG
NOTION	N OW SH AH N
NOVA	N OW V AH
NOVEL	N AA V AH L
NOVEMBER	N OW V EH M B ER
NOW	N AW
NUCLEAR	N UW K L IY ER
NUMBER	N AH M B ER
NUMBERS	N AH M B ER Z
NUMEROUS	N UW M ER AH S
NURSING	N ER S IH NG
O.	OW
O.S	OW Z
OBJECTIONS	AH B JH EH K SH AH N Z
OBJECTIVE	AH B JH EH K T IH V
OBLIGATION	AA B L AH G EY SH AH N
OBLIGATIONS	AA B L AH G EY SH AH N Z
OBSERVERS	AH B Z ER V ER Z
OBTAIN	AH B T EY N
OBTAINED	AH B T EY N D
OBVIOUS	AA B V IY AH S
OBVIOUSLY	AA B V IY AH S L IY
OCCASIONALLY	AH K EY ZH AH N AH L IY
OCCASIONALLY(2)	AH K EY ZH AH N L IY
OCCASIONALLY(3)	AH K EY ZH N AH L IY
OCCIDENTAL	AA K S AH D EH N AH L
OCCIDENTAL(2)	AA K S AH D EH N T AH L
OCCUPIED	AA K Y AH P AY D
OCCUR	AH K ER
OCCURRED	AH K ER D
OCEAN	OW SH AH N
OCTOBER	AA K T OW B ER
ODDS	AA D Z
OF	AH V
OFF	AO F
OFFENSIVE	AH F EH N S IH V
OFFER	AO F ER
OFFERED	AO F ER D
OFFERING	AO F ER IH NG
OFFERING(2)	AO F R IH NG
OFFERINGS	AO F ER IH NG Z
OFFERINGS(2)	AO F R IH NG Z
OFFERS	AO F ER Z
OFFICE	AO F AH S
OFFICER	AO F AH S ER
OFFICER(2)	AO F IH S ER
OFFICERS	AO F AH S ER Z
OFFICERS(2)	AO F IH S ER Z
OFFICES	AO F AH S AH Z
OFFICES(2)	AO F AH S IH Z
OFFICIAL	AH F IH SH AH L
OFFICIALLY	AH F IH SH AH L IY
OFFICIALS	AH F IH SH AH L Z
OFFS	AO F S
OFFSET	AO F S EH T
OFFSHORE	AO F SH AO R
OFTEN	AO F AH N
OFTEN(2)	AO F T AH N
OH	OW
OHIO	OW HH AY OW
OIL	OY L
OKLAHOMA	OW K L AH HH OW M AH
OLD	OW L D
OLDER	OW L D ER
OLIVER	AA L AH V ER
OLIVER(2)	AA L IH V ER
OLYMPIC	OW L IH M P IH K
OLYMPICS	OW L IH M P IH K S
ON	AA N
ON(2)	AO N
ONCE	W AH N S
ONE	HH W AH N
ONE(2)	W AH N
ONES	W AH N Z
ONLY	OW N L IY
ONTARIO	AA N T EH R IY OW
ONTO	AA N T UW
ONTO(2)	AO N T UW
OPEC	OW P EH K
OPEN	OW P AH N
OPENED	OW P AH N D
OPENING	OW P AH N IH NG
OPERA	AA P R AH
OPERATE	AA P ER EY T
OPERATE(2)	AO P ER EY T
OPERATED	AA P ER EY T AH D
OPERATES	AA P ER EY T S
OPERATING	AA P ER EY T IH NG
OPERATING(2)	AO P ER EY T IH NG
OPERATION	AA P ER EY SH AH N
OPERATIONS	AA P ER EY SH AH N Z
OPERATOR	AA P ER EY T ER
OPERATORS	AA P ER EY T ER Z
OPERATORS(2)	AO P ER EY T ER Z
OPINION	AH P IH N Y AH N
OPPENHEIMER	AA P AH N HH AY M ER
OPPONENTS	AH P OW N AH N T S
OPPORTUNITIES	AA P ER T UW N AH T IY Z
OPPORTUNITY	AA P ER T UW N AH T IY
OPPOSE	AH P OW Z
OPPOSED	AH P OW Z D
OPPOSES	AH P OW Z IH Z
OPPOSITE	AA P AH Z AH T
OPPOSITE(2)	AA P Z AH T
OPPOSITION	AA P AH Z IH SH AH N
OPTIMISM	AA P T AH M IH Z AH M
OPTIMISTIC	AA P T AH M IH S T IH K
OPTION	AA P SH AH N
OPTION(2)	AO P SH AH N
OPTIONS	AA P SH AH N Z
OPTIONS(2)	AO P SH AH N Z
OR	AO R
OR(2)	ER
ORANGE	AO R AH N JH
ORANGE(2)	AO R IH N JH
ORDER	AO R D ER
ORDERED	AO R D ER D
ORDERS	AO R D ER Z
ORDINARY	AO R D AH N EH R IY
OREGON	AO R AH G AA N
OREGON(2)	AO R AH G AH N
ORGANIZATION	AO R G AH N AH Z EY SH AH N
ORGANIZATIONS	AO R G AH N AH Z EY SH AH N Z
ORGANIZED	AO R G AH N AY Z D
ORIENTED	AO R IY EH N T AH D
ORIENTED(2)	AO R IY EH N T IH D
ORIGINAL	ER IH JH AH N AH L
ORIGINALLY	ER IH JH AH N AH L IY
ORIGINALLY(2)	ER IH JH N AH L IY
ORLEANS	AO R L IY AH N Z
ORLEANS(2)	AO R L IY N Z
OTHER	AH DH ER
OTHERS	AH DH ER Z
OTHERWISE	AH DH ER W AY Z
OUGHT	AO T
OUNCE	AW N S
OUNCES	AW N S AH Z
OUNCES(2)	AW N S IH Z
OUR	AA R
OUR(2)	AW ER
OUR(3)	AW R
OURSELVES	AA R S EH L V Z
OURSELVES(2)	AW ER S EH L V Z
OUT	AW T
OUTCOME	AW T K AH M
OUTLAYS	AW T L EY Z
OUTLETS	AW T L EH T S
OUTLOOK	AW T L UH K
OUTPUT	AW T P UH T
OUTS	AW T S
OUTSIDE	AW T S AY D
OUTSTANDING	AW T S T AE N D IH NG
OVER	OW V ER
OVERALL	OW V ER AO L
OVERCOME	OW V ER K AH M
OVERHAUL	OW V ER HH AO L
OVERNIGHT	OW V ER N AY T
OVERSEAS	OW V ER S IY Z
OWED	OW D
OWN	OW N
OWNED	OW N D
OWNER	OW N ER
OWNERS	OW N ER Z
OWNERSHIP	OW N ER SH IH P
OWNS	OW N Z
P.	P IY
P.'S	P IY Z
PACE	P EY S
PACIFIC	P AH S IH F IH K
PACKAGE	P AE K AH JH
PACKAGE(2)	P AE K IH JH
PACKAGES	P AE K AH JH AH Z
PACKAGES(2)	P AE K IH JH IH Z
PACKAGING	P AE K IH JH IH NG
PACKARD	P AE K ER D
PACT	P AE K T
PAGE	P EY JH
PAGES	P EY JH AH Z
PAGES(2)	P EY JH IH Z
PAID	P EY D
PAIN	P EY N
PAINEWEBBER	P EY N W EH B ER
PAINTINGS	P EY N IH NG Z
PAINTINGS(2)	P EY N T IH NG Z
PAKISTAN	P AE K IH S T AE N
PALESTINIAN	P AE L IH S T IH N IY AH N
PAN	P AE N
PANAMA	P AE N AH M AA
PANEL	P AE N AH L
PANIC	P AE N IH K
PAPER	P EY P ER
PAPERS	P EY P ER Z
PAR	P AA R
PARENT	P EH R AH N T
PARENTS	P EH R AH N T S
PARIS	P AE R IH S
PARIS(2)	P EH R IH S
PARK	P AA R K
PARKER	P AA R K ER
PARKING	P AA R K IH NG
PARLIAMENT	P AA R L AH M AH N T
PARLIAMENTARY	P AA R L AH M EH N ER IY
PARLIAMENTARY(2)	P AA R L AH M EH N T ER IY
PART	P AA R T
PARTIAL	P AA R SH AH L
PARTICIPANTS	P AA R T IH S AH P AH N T S
PARTICIPATE	P AA R T IH S AH P EY T
PARTICIPATING	P AA R T IH S AH P EY T IH NG
PARTICIPATION	P AA R T IH S AH P EY SH AH N
PARTICULAR	P AA T IH K Y AH L ER
PARTICULAR(2)	P ER T IH K Y AH L ER
PARTICULARLY	P AA R T IH K Y AH L ER L IY
PARTICULARLY(2)	P ER T IH K Y AH L ER L IY
PARTIES	P AA R T IY Z
PARTLY	P AA R T L IY
PARTNER	P AA R T N ER
PARTNERS	P AA R T N ER Z
PARTNERSHIP	P AA R T N ER SH IH P
PARTNERSHIPS	P AA R T N ER SH IH P S
PARTS	P AA R T S
PARTY	P AA R T IY
PARTY'S	P AA R T IY Z
PASS	P AE S
PASSAGE	P AE S AH JH
PASSAGE(2)	P AE S IH JH
PASSED	P AE S T
PASSENGER	P AE S AH N JH ER
PASSENGERS	P AE S AH N JH ER Z
PASSING	P AE S IH NG
PAST	P AE S T
PATENT	P AE T AH N T
PATH	P AE TH
PATIENT	P EY SH AH N T
PATIENTS	P EY SH AH N T S
PATIENTS(2)	P EY SH AH N Z
PATRICK	P AE T R IH K
PATTERN	P AE T ER N
PAUL	P AO L
PAY	P EY
PAYABLE	P EY AH B AH L
PAYING	P EY IH NG
PAYMENT	P EY M AH N T
PAYMENTS	P EY M AH N T S
PAYOUT	P EY AW T
PAYROLL	P EY R OW L
PAYS	P EY Z
PEABODY	P IY B AA D IY
PEACE	P IY S
PEAK	P IY K
PEAT	P IY T
PENALTIES	P EH N AH L T IY Z
PENALTY	P EH N AH L T IY
PENCE	P EH N S
PENDING	P EH N D IH NG
PENNSYLVANIA	P EH N S AH L V EY N Y AH
PENNZOIL	P EH N Z OY L
PENSION	P EH N SH AH N
PENTAGON	P EH N IH G AA N
PENTAGON(2)	P EH N T IH G AA N
PEOPLE	P IY P AH L
PEOPLE'S	P IY P AH L Z
PER	P ER
PERCEIVED	P ER S IY V D
PERCENTAGE	P ER S EH N AH JH
PERCENTAGE(2)	P ER S EH N IH JH
PERCENTAGE(3)	P ER S EH N T AH JH
PERCENTAGE(4)	P ER S EH N T IH JH
PERCEPTION	P ER S EH P SH AH N
PERFECT	P ER F EH K T
PERFECT(2)	P ER F IH K T
PERFORM	P ER F AO R M
PERFORMANCE	P ER F AO R M AH N S
PERFORMED	P ER F AO R M D
PERFORMING	P ER F AO R M IH NG
PERHAPS	P ER HH AE P S
PERIOD	P IH R IY AH D
PERIODS	P IH R IY AH D Z
PERMANENT	P ER M AH N AH N T
PERMISSION	P ER M IH SH AH N
PERMIT	P ER M IH T
PERMITS	P ER M IH T S
PERMITTED	P ER M IH T AH D
PERMITTED(2)	P ER M IH T IH D
PEROT	P ER OW
PERSIAN	P ER ZH AH N
PERSON	P ER S AH N
PERSONAL	P ER S IH N IH L
PERSONALLY	P ER S AH N AH L IY
PERSONALLY(2)	P ER S AH N L IY
PERSONALLY(3)	P ER S N AH L IY
PERSONNEL	P ER S AH N EH L
PERSONS	P ER S AH N Z
PERSPECTIVE	P ER S P EH K T IH V
PERSUADE	P ER S W EY D
PETER	P IY T ER
PETITION	P AH T IH SH AH N
PETROLEUM	P AH T R OW L IY AH M
PHARMACEUTICAL	F AA R M AH S UW T IH K AH L
PHARMACEUTICALS	F AA R M AH S UW T IH K AH L Z
PHASE	F EY Z
PHILADELPHIA	F IH L AH D EH L F IY AH
PHILIP	F IH L AH P
PHILIP(2)	F IH L IH P
PHILIPPINE	F IH L AH P IY N
PHILIPPINES	F IH L AH P IY N Z
PHILIPS	F IH L AH P S
PHILIPS(2)	F IH L IH P S
PHILLIPS	F IH L IH P S
PHILOSOPHY	F AH L AA S AH F IY
PHOENIX	F IY N IH K S
PHONE	F OW N
PHYSICAL	F IH Z IH K AH L
PHYSICIANS	F AH Z IH SH AH N Z
PHYSICIANS(2)	F IH Z IH SH AH N Z
PICK	P IH K
PICKED	P IH K T
PICKENS	P IH K AH N Z
PICKING	P IH K IH NG
PICTURE	P IH K CH ER
PICTURES	P IH K CH ER Z
PIECE	P IY S
PIECES	P IY S AH Z
PIECES(2)	P IY S IH Z
PILL	P IH L
PILLSBURY	P IH L Z B EH R IY
PILOT	P AY L AH T
PILOTS	P AY L AH T S
PIPELINE	P AY P L AY N
PIT	P IH T
PITTSBURGH	P IH T S B ER G
PIZZA	P IY T S AH
PLACE	P L EY S
PLACED	P L EY S T
PLACEMENT	P L EY S M AH N T
PLACES	P L EY S AH Z
PLACES(2)	P L EY S IH Z
PLAINTIFFS	P L EY N IH F S
PLAINTIFFS(2)	P L EY N T IH F S
PLAN	P L AE N
PLANE	P L EY N
PLANES	P L EY N Z
PLANNED	P L AE N D
PLANNERS	P L AE N ER Z
PLANNING	P L AE N IH NG
PLANS	P L AE N Z
PLANT	P L AE N T
PLANTS	P L AE N T S
PLASTIC	P L AE S T IH K
PLASTICS	P L AE S T IH K S
PLATFORM	P L AE T F AO R M
PLATINUM	P L AE T AH N AH M
PLATINUM(2)	P L AE T N AH M
PLAY	P L EY
PLAYED	P L EY D
PLAYER	P L EY ER
PLAYERS	P L EY ER Z
PLAYING	P L EY IH NG
PLAYS	P L EY Z
PLEA	P L IY
PLEADED	P L IY D AH D
PLEADED(2)	P L IY D IH D
PLEASED	P L IY Z D
PLEDGE	P L EH JH
PLEDGED	P L EH JH D
PLENTY	P L EH N IY
PLENTY(2)	P L EH N T IY
PLUMMETED	P L AH M AH T IH D
PLUNGE	P L AH N JH
PLUNGED	P L AH N JH D
PLUS	P L AH S
POINDEXTER	P OY N D EH K S T ER
POINT	P OY N T
POINTED	P OY N AH D
POINTED(2)	P OY N T AH D
POINTED(3)	P OY N T IH D
POINTS	P OY N T S
POISON	P OY Z AH N
POLAND	P OW L AH N D
POLICE	P AH L IY S
POLICIES	P AA L AH S IY Z
POLICY	P AA L AH S IY
POLISH	P AA L IH SH
POLISH(2)	P OW L IH SH
POLITICAL	P AH L IH T AH K AH L
POLITICAL(2)	P AH L IH T IH K AH L
POLITICALLY	P AH L IH T IH K AH L IY
POLITICALLY(2)	P L IH T IH K L IY
POLITICIANS	P AA L AH T IH SH AH N Z
POLITICS	P AA L AH T IH K S
POLL	P OW L
POLLS	P OW L Z
POLLUTION	P AH L UW SH AH N
PONT	P AA N T
POOL	P UW L
POOR	P UH R
POOR'S	P UH R Z
POPULAR	P AA P Y AH L ER
POPULARITY	P AA P Y AH L EH R AH T IY
POPULATION	P AA P Y AH L EY SH AH N
PORK	P AO R K
PORT	P AO R T
PORTFOLIO	P AO R T F OW L IY OW
PORTFOLIOS	P AO R T F OW L IY OW Z
PORTION	P AO R SH AH N
POSE	P OW Z
POSITION	P AH Z IH SH AH N
POSITIONS	P AH Z IH SH AH N Z
POSITIVE	P AA Z AH T IH V
POSSIBILITY	P AA S AH B IH L AH T IY
POSSIBLE	P AA S AH B AH L
POSSIBLY	P AA S AH B L IY
POST	P OW S T
POSTAL	P OW S T AH L
POSTED	P OW S T IH D
POSTPONED	P OW S P OW N D
POSTPONED(2)	P OW S T P OW N D
POSTS	P OW S
POSTS(2)	P OW S S
POSTS(3)	P OW S T S
POTENTIAL	P AH T EH N CH AH L
POTENTIAL(2)	P AH T EH N SH AH L
POTENTIALLY	P AH T EH N CH AH L IY
POTENTIALLY(2)	P AH T EH N SH AH L IY
POUND	P AW N D
POUNDS	P AW N D Z
POUNDS(2)	P AW N Z
POVERTY	P AA V ER T IY
POWER	P AW ER
POWERFUL	P AW ER F AH L
POWERS	P AW ER Z
PRACTICAL	P R AE K T AH K AH L
PRACTICAL(2)	P R AE K T IH K AH L
PRACTICE	P R AE K T AH S
PRACTICE(2)	P R AE K T IH S
PRACTICES	P R AE K T AH S AH Z
PRACTICES(2)	P R AE K T IH S IH Z
PRE	P R IY
PRECIOUS	P R EH SH AH S
PRECISELY	P R IH S AY S L IY
PRECISELY(2)	P R IY S AY S L IY
PREDICT	P R IH D IH K T
PREDICT(2)	P R IY D IH K T
PREDICTED	P R IH D IH K T IH D
PREDICTED(2)	P R IY D IH K T AH D
PREDICTED(3)	P R IY D IH K T IH D
PREDICTING	P R IH D IH K T IH NG
PREDICTING(2)	P R IY D IH K T IH NG
PREDICTS	P R IH D IH K S
PREDICTS(2)	P R IH D IH K T S
PREDICTS(3)	P R IY D IH K S
PREDICTS(4)	P R IY D IH K T S
PREFER	P R AH F ER
PREFER(2)	P R IH F ER
PREFER(3)	P R IY F ER
PREFERENCE	P R EH F ER AH N S
PREFERENCE(2)	P R EH F R AH N S
PREFERRED	P R AH F ER D
PREFERRED(2)	P R IH F ER D
PREFERRED(3)	P R IY F ER D
PRELIMINARY	P R IH L IH M AH N EH R IY
PRELIMINARY(2)	P R IY L IH M AH N EH R IY
PREMIER	P R EH M IH R
PREMIER(2)	P R IY M IH R
PREMIUM	P R IY M IY AH M
PREMIUMS	P R IY M IY AH M Z
PREPARE	P R IY P EH R
PREPARED	P R IY P EH R D
PREPARING	P ER P EH R IH NG
PREPARING(2)	P R IY P EH R IH NG
PRESCRIPTION	P R AH S K R IH P SH AH N
PRESENCE	P R EH Z AH N S
PRESENT	P ER Z EH N T
PRESENT(2)	P R EH Z AH N T
PRESENT(3)	P R IY Z EH N T
PRESENTED	P ER Z EH N AH D
PRESENTED(2)	P ER Z EH N T AH D
PRESENTED(3)	P R IY Z EH N AH D
PRESENTED(4)	P R IY Z EH N T AH D
PRESERVE	P R AH Z ER V
PRESERVE(2)	P R IH Z ER V
PRESERVE(3)	P R IY Z ER V
PRESIDENCY	P R EH Z AH D AH N S IY
PRESIDENT	P R EH Z AH D EH N T
PRESIDENT(2)	P R EH Z IH D AH N T
PRESIDENT'S	P R EH Z IH D AH N T S
PRESIDENTIAL	P R EH Z AH D EH N CH AH L
PRESIDENTIAL(2)	P R EH Z AH D EH N SH AH L
PRESIDENTS	P R EH Z AH D EH N T S
PRESIDENTS(2)	P R EH Z IH D AH N S
PRESIDENTS(3)	P R EH Z IH D AH N T S
PRESS	P R EH S
PRESSED	P R EH S T
PRESSING	P R EH S IH NG
PRESSURE	P R EH SH ER
PRESSURES	P R EH SH ER Z
PRETAX	P R IY T AE K S
PRETTY	P R IH T IY
PREVENT	P R IH V EH N T
PREVENT(2)	P R IY V EH N T
PREVIOUS	P R IY V IY AH S
PREVIOUSLY	P R IY V IY AH S L IY
PRICE	P R AY S
PRICED	P R AY S T
PRICES	P R AY S AH Z
PRICES(2)	P R AY S IH Z
PRICING	P R AY S IH NG
PRIMARILY	P R AY M EH R AH L IY
PRIMARY	P R AY M EH R IY
PRIME	P R AY M
PRINCETON	P R IH N S T AH N
PRINCIPAL	P R IH N S AH P AH L
PRINCIPLE	P R IH N S AH P AH L
PRINCIPLES	P R IH N S AH P AH L Z
PRINT	P R IH N T
PRINTING	P R IH N IH NG
PRINTING(2)	P R IH N T IH NG
PRIOR	P R AY ER
PRIORITY	P R AY AO R AH T IY
PRISON	P R IH Z AH N
PRIVATE	P R AY V AH T
PRIVATELY	P R AY V AH T L IY
PRIVATIZATION	P R AY V AH T AH Z EY SH AH N
PRIZE	P R AY Z
PRO	P R OW
PROBABLY	P R AA B AH B L IY
PROBABLY(2)	P R AA B L IY
PROBE	P R OW B
PROBLEM	P R AA B L AH M
PROBLEMS	P R AA B L AH M Z
PROCEDURE	P R AH S IY JH ER
PROCEDURE(2)	P R OW S IY JH ER
PROCEDURES	P R AH S IY JH ER Z
PROCEDURES(2)	P R OW S IY JH ER Z
PROCEED	P ER S IY D
PROCEED(2)	P R AH S IY D
PROCEED(3)	P R OW S IY D
PROCEEDINGS	P R AH S IY D IH NG Z
PROCEEDINGS(2)	P R OW S IY D IH NG Z
PROCEEDS	P R AH S IY D Z
PROCEEDS(2)	P R OW S IY D Z
PROCESS	P R AA S EH S
PROCESS(2)	P R AO S EH S
PROCESSING	P R AA S EH S IH NG
PROCUREMENT	P R OW K Y UH R M AH N T
PRODUCE	P R AH D UW S
PRODUCE(2)	P R OW D UW S
PRODUCED	P R AH D UW S T
PRODUCER	P R AH D UW S ER
PRODUCERS	P R AH D UW S ER Z
PRODUCES	P R AH D UW S AH Z
PRODUCES(2)	P R AH D UW S IH Z
PRODUCING	P R AH D UW S IH NG
PRODUCT	P R AA D AH K T
PRODUCTION	P ER D AH K SH AH N
PRODUCTION(2)	P R AH D AH K SH AH N
PRODUCTION(3)	P R OW D AH K SH AH N
PRODUCTIVITY	P R OW D AH K T IH V AH T IY
PRODUCTIVITY(2)	P R OW D AH K T IH V IH T IY
PRODUCTS	P R AA D AH K S
PRODUCTS(2)	P R AA D AH K T S
PROFESSIONAL	P R AH F EH SH AH N AH L
PROFESSIONALS	P R AH F EH SH AH N AH L Z
PROFESSOR	P R AH F EH S ER
PROFILE	P R OW F AY L
PROFIT	P R AA F AH T
PROFIT(2)	P R AA F IH T
PROFITABILITY	P R AA F IH T AH B IH L IH T IY
PROFITABLE	P R AA F AH T AH B AH L
PROFITS	P R AA F IH T S
PROGRAM	P R OW G R AE M
PROGRAMMING	P R OW G R AE M IH NG
PROGRAMS	P R OW G R AE M Z
PROGRESS	P R AA G R EH S
PROGRESS(2)	P R AH G R EH S
PROGRESS(3)	P R OW G R EH S
PROJECT	P R AA JH EH K T
PROJECT(2)	P R AH JH EH K T
PROJECTED	P R AH JH EH K T AH D
PROJECTIONS	P R AH JH EH K SH AH N Z
PROJECTS	P R AA JH EH K S
PROJECTS(2)	P R AA JH EH K T S
PROJECTS(3)	P R AH JH EH K S
PROJECTS(4)	P R AH JH EH K T S
PROMINENT	P R AA M AH N AH N T
PROMISE	P R AA M AH S
PROMISED	P R AA M AH S T
PROMISES	P R AA M AH S AH Z
PROMISING	P R AA M AH S IH NG
PROMOTE	P R AH M OW T
PROMOTING	P R AH M OW T IH NG
PROMOTION	P ER M OW SH AH N
PROMOTION(2)	P R AH M OW SH AH N
PROMPT	P R AA M P T
PROMPTED	P R AA M P T AH D
PROMPTED(2)	P R AA M P T IH D
PROOF	P R UW F
PROPER	P R AA P ER
PROPERLY	P R AA P ER L IY
PROPERTIES	P R AA P ER T IY Z
PROPERTY	P R AA P ER T IY
PROPORTION	P R AH P AO R SH AH N
PROPOSAL	P R AH P OW Z AH L
PROPOSALS	P R AH P OW Z AH L Z
PROPOSE	P R AH P OW Z
PROPOSED	P R AH P OW Z D
PROPOSING	P R AH P OW Z IH NG
PROSECUTOR	P R AA S IH K Y UW T ER
PROSECUTORS	P R AA S IH K Y UW T ER Z
PROSPECT	P R AA S P EH K T
PROSPECTIVE	P R AH S P EH K T IH V
PROSPECTS	P R AA S P EH K S
PROSPECTS(2)	P R AA S P EH K T S
PROTECT	P ER T EH K T
PROTECT(2)	P R AH T EH K T
PROTECTED	P ER T EH K T IH D
PROTECTED(2)	P R AH T EH K T AH D
PROTECTED(3)	P R AH T EH K T IH D
PROTECTION	P ER T EH K SH AH N
PROTECTION(2)	P R AH T EH K SH AH N
PROTECTIONIST	P ER T EH K SH AH N IH S T
PROTECTIONIST(2)	P R AH T EH K SH AH N IH S T
PROTEST	P R AH T EH S T
PROTEST(2)	P R OW T EH S T
PROTESTS	P R AH T EH S
PROTESTS(2)	P R AH T EH S S
PROTESTS(3)	P R AH T EH S T S
PROTESTS(4)	P R OW T EH S
PROTESTS(5)	P R OW T EH S S
PROTESTS(6)	P R OW T EH S T S
PROVE	P R UW V
PROVED	P R UW V D
PROVIDE	P R AH V AY D
PROVIDED	P R AH V AY D AH D
PROVIDED(2)	P R AH V AY D IH D
PROVIDES	P R AH V AY D Z
PROVIDING	P R AH V AY D IH NG
PROVINCE	P R AA V AH N S
PROVINCE(2)	P R AA V IH N S
PROVISION	P R AH V IH ZH AH N
PROVISIONS	P R AH V IH ZH AH N Z
PROXY	P R AA K S IY
PRUDENTIAL	P R UW D EH N CH AH L
PRUDENTIAL(2)	P R UW D EH N SH AH L
PUBLIC	P AH B L IH K
PUBLICATION	P AH B L IH K EY SH AH N
PUBLICATIONS	P AH B L IH K EY SH AH N Z
PUBLICITY	P AH B L IH S AH T IY
PUBLICITY(2)	P AH B L IH S IH T IY
PUBLICLY	P AH B L IH K L IY
PUBLISHED	P AH B L IH SH T
PUBLISHER	P AH B L IH SH ER
PUBLISHERS	P AH B L IH SH ER Z
PUBLISHING	P AH B L IH SH IH NG
PULL	P UH L
PULLED	P UH L D
PULP	P AH L P
PUNITIVE	P Y UW N AH T IH V
PURCHASE	P ER CH AH S
PURCHASED	P ER CH AH S T
PURCHASES	P ER CH AH S AH Z
PURCHASES(2)	P ER CH AH S IH Z
PURCHASING	P ER CH AH S IH NG
PURPOSE	P ER P AH S
PURPOSES	P ER P AH S AH Z
PURPOSES(2)	P ER P AH S IH Z
PURSUE	P ER S UW
PURSUING	P ER S UW IH NG
PUSH	P UH SH
PUSHED	P UH SH T
PUSHING	P UH SH IH NG
PUT	P UH T
PUTS	P UH T S
PUTTING	P AH T IH NG
PUTTING(2)	P UH T IH NG
Q.	K Y UW
QUALIFIED	K W AA L AH F AY D
QUALIFY	K W AA L AH F AY
QUALITY	K W AA L AH T IY
QUARTER	K AO R T ER
QUARTER(2)	K W AO R T ER
QUARTERLY	K AO R T ER L IY
QUARTERLY(2)	K W AO R T ER L IY
QUARTERS	K W AO R T ER Z
QUAYLE	K W EY L
QUEBEC	K W AH B EH K
QUESTION	K W EH S CH AH N
QUESTION(2)	K W EH SH AH N
QUESTIONED	K W EH S CH AH N D
QUESTIONS	K W EH S CH AH N Z
QUICK	K W IH K
QUICKLY	K W IH K L IY
QUIET	K W AY AH T
QUIETLY	K W AY AH T L IY
QUIT	K W IH T
QUITE	K W AY T
QUOTA	K W OW T AH
QUOTAS	K W OW T AH Z
QUOTED	K W OW T AH D
QUOTED(2)	K W OW T IH D
R.	AA R
R.'S	AA R Z
RACE	R EY S
RACIAL	R EY SH AH L
RADAR	R EY D AA R
RADICAL	R AE D AH K AH L
RADICAL(2)	R AE D IH K AH L
RADIO	R EY D IY OW
RAIDERS	R EY D ER Z
RAIL	R EY L
RAILROAD	R EY L R OW D
RAIN	R EY N
RAISE	R EY Z
RAISED	R EY Z D
RAISES	R EY Z AH Z
RAISES(2)	R EY Z IH Z
RAISING	R EY Z IH NG
RALLIED	R AE L IY D
RALLY	R AE L IY
RALPH	R AE L F
RAN	R AE N
RANGE	R EY N JH
RANGED	R EY N JH D
RANGING	R EY N JH IH NG
RANK	R AE NG K
RANKED	R AE NG K T
RANKING	R AE NG K IH NG
RANKS	R AE NG K S
RAPID	R AE P AH D
RAPID(2)	R AE P IH D
RAPIDLY	R AE P AH D L IY
RARE	R EH R
RARELY	R EH R L IY
RATE	R EY T
RATED	R EY T AH D
RATED(2)	R EY T IH D
RATES	R EY T S
RATHER	R AE DH ER
RATHER(2)	R AH DH ER
RATING	R EY T IH NG
RATINGS	R EY T IH NG Z
RATIO	R EY SH IY OW
RAW	R AA
RAY	R EY
RAYMOND	R EY M AH N D
RE	R EY
RE(2)	R IY
REACH	R IY CH
REACHED	R IY CH T
REACHING	R IY CH IH NG
REACTION	R IY AE K SH AH N
READ	R EH D
READ(2)	R IY D
READERS	R IY D ER Z
READING	R EH D IH NG
READING(2)	R IY D IH NG
READY	R EH D IY
REAGAN	R EY G AH N
REAGAN(2)	R IY G AH N
REAGAN'S	R EY G AH N Z
REAGAN'S(2)	R IY G AH N Z
REAL	R IY L
REALITY	R IY AE L AH T IY
REALIZE	R IY AH L AY Z
REALIZE(2)	R IY L AY Z
REALIZED	R IY AH L AY Z D
REALIZED(2)	R IY L AY Z D
REALLY	R IH L IY
REALLY(2)	R IY L IY
REALTY	R IH L IH T IY
REALTY(2)	R IY AH L T IY
REALTY(3)	R IY L T IY
REASON	R IY Z AH N
REASONABLE	R IY Z AH N AH B AH L
REASONABLE(2)	R IY Z N AH B AH L
REASONS	R IY Z AH N Z
REBELS	R EH B AH L Z
REBELS(2)	R IH B EH L Z
REBOUND	R IY B AW N D
REBOUNDED	R IY B AW N D IH D
RECALL	R IH K AO L
RECALL(2)	R IY K AO L
RECALLS	R IH K AO L Z
RECALLS(2)	R IY K AO L Z
RECAPITALIZATION	R IY K AE P IH T AH L IH Z EY SH AH N
RECEIPTS	R IH S IY T S
RECEIPTS(2)	R IY S IY T S
RECEIVE	R AH S IY V
RECEIVE(2)	R IH S IY V
RECEIVE(3)	R IY S IY V
RECEIVED	R AH S IY V D
RECEIVED(2)	R IH S IY V D
RECEIVED(3)	R IY S IY V D
RECEIVING	R AH S IY V IH NG
RECEIVING(2)	R IH S IY V IH NG
RECEIVING(3)	R IY S IY V IH NG
RECENT	R IY S AH N T
RECENTLY	R IY S AH N L IY
RECENTLY(2)	R IY S AH N T L IY
RECESSION	R IH S EH SH AH N
RECESSION(2)	R IY S EH SH AH N
RECOGNITION	R EH K AH G N IH SH AH N
RECOGNITION(2)	R EH K IH G N IH SH AH N
RECOGNIZE	R EH K AH G N AY Z
RECOGNIZED	R EH K AH G N AY Z D
RECOMMEND	R EH K AH M EH N D
RECOMMENDATION	R EH K AH M AH N D EY SH AH N
RECOMMENDATIONS	R EH K AH M AH N D EY SH AH N Z
RECOMMENDED	R EH K AH M EH N D AH D
RECOMMENDED(2)	R EH K AH M EH N D IH D
RECORD	R AH K AO R D
RECORD(2)	R EH K ER D
RECORD(3)	R IH K AO R D
RECORDED	R AH K AO R D AH D
RECORDED(2)	R IH K AO R D IH D
RECORDS	R AH K AO R D Z
RECORDS(2)	R EH K ER D Z
RECORDS(3)	R IH K AO R D Z
RECOVER	R IH K AH V ER
RECOVERED	R AH K AH V ER D
RECOVERED(2)	R IH K AH V ER D
RECOVERY	R IH K AH V ER IY
RECOVERY(2)	R IH K AH V R IY
RED	R EH D
REDEEM	R IH D IY M
REDEMPTION	R IH D EH M P SH AH N
REDEMPTION(2)	R IH D EH M SH AH N
REDUCE	R AH D UW S
REDUCE(2)	R IH D UW S
REDUCE(3)	R IY D UW S
REDUCED	R AH D UW S T
REDUCED(2)	R IH D UW S T
REDUCED(3)	R IY D UW S T
REDUCING	R AH D UW S IH NG
REDUCING(2)	R IH D UW S IH NG
REDUCING(3)	R IY D UW S IH NG
REDUCTION	R AH D AH K SH AH N
REDUCTION(2)	R IY D AH K SH AH N
REDUCTIONS	R IY D AH K SH AH N Z
REED	R IY D
REFERENCE	R EH F ER AH N S
REFERENCE(2)	R EH F R AH N S
REFERRED	R AH F ER D
REFERRED(2)	R IH F ER D
REFERRING	R IH F ER IH NG
REFINING	R AH F AY N IH NG
REFINING(2)	R IH F AY N IH NG
REFLECT	R AH F L EH K T
REFLECT(2)	R IH F L EH K T
REFLECTED	R AH F L EH K T AH D
REFLECTED(2)	R IH F L EH K T IH D
REFLECTING	R AH F L EH K T IH NG
REFLECTING(2)	R IH F L EH K T IH NG
REFLECTS	R IH F L EH K S
REFLECTS(2)	R IH F L EH K T S
REFORM	R AH F AO R M
REFORM(2)	R IH F AO R M
REFORMS	R AH F AO R M Z
REFORMS(2)	R IH F AO R M Z
REFUSAL	R AH F Y UW Z AH L
REFUSAL(2)	R IH F Y UW Z AH L
REFUSE	R AH F Y UW Z
REFUSE(2)	R EH F Y UW Z
REFUSE(3)	R IH F Y UW Z
REFUSED	R AH F Y UW Z D
REFUSED(2)	R IH F Y UW Z D
REGAN	R IY G AH N
REGARD	R AH G AA R D
REGARD(2)	R IH G AA R D
REGARDED	R AH G AA R D AH D
REGARDED(2)	R IH G AA R D IH D
REGARDING	R AH G AA R D IH NG
REGARDING(2)	R IH G AA R D IH NG
REGARDLESS	R AH G AA R D L AH S
REGIME	R AH ZH IY M
REGIME(2)	R EY ZH IY M
REGION	R IY JH AH N
REGIONAL	R IY JH AH N AH L
REGIONS	R IY JH AH N Z
REGISTERED	R EH JH IH S T ER D
REGISTRATION	R EH JH IH S T R EY SH AH N
REGULAR	R EH G Y AH L ER
REGULAR(2)	R EY G Y AH L ER
REGULARLY	R EH G Y AH L ER L IY
REGULATION	R EH G Y AH L EY SH AH N
REGULATIONS	R EH G Y AH L EY SH AH N Z
REGULATORS	R EH G Y AH L EY T ER Z
REGULATORY	R EH G Y AH L AH T AO R IY
REITERATED	R IY IH T ER EY T IH D
REJECT	R IH JH EH K T
REJECT(2)	R IY JH EH K T
REJECTED	R IH JH EH K T IH D
REJECTED(2)	R IY JH EH K T AH D
REJECTED(3)	R IY JH EH K T IH D
REJECTION	R IH JH EH K SH AH N
REJECTION(2)	R IY JH EH K SH AH N
RELATED	R IH L EY T IH D
RELATED(2)	R IY L EY T AH D
RELATED(3)	R IY L EY T IH D
RELATIONS	R IY L EY SH AH N Z
RELATIONSHIP	R IY L EY SH AH N SH IH P
RELATIONSHIPS	R IY L EY SH AH N SH IH P S
RELATIVE	R EH L AH T IH V
RELATIVELY	R EH L AH T IH V L IY
RELEASE	R IY L IY S
RELEASED	R IY L IY S T
RELIANCE	R IH L AY AH N S
RELIANCE(2)	R IY L AY AH N S
RELIEF	R IH L IY F
RELIEF(2)	R IY L IY F
RELIGIOUS	R IH L IH JH AH S
RELIGIOUS(2)	R IY L IH JH AH S
RELUCTANT	R IH L AH K T AH N T
RELUCTANT(2)	R IY L AH K T AH N T
RELY	R IH L AY
RELY(2)	R IY L AY
REMAIN	R IH M EY N
REMAIN(2)	R IY M EY N
REMAINDER	R IH M EY N D ER
REMAINDER(2)	R IY M EY N D ER
REMAINED	R IH M EY N D
REMAINED(2)	R IY M EY N D
REMAINING	R IH M EY N IH NG
REMAINING(2)	R IY M EY N IH NG
REMAINS	R IH M EY N Z
REMAINS(2)	R IY M EY N Z
REMARKABLE	R IH M AA R K AH B AH L
REMARKABLE(2)	R IY M AA R K AH B AH L
REMARKS	R IH M AA R K S
REMARKS(2)	R IY M AA R K S
REMEMBER	R IH M EH M B ER
REMEMBER(2)	R IY M EH M B ER
REMOVE	R IY M UW V
REMOVED	R IY M UW V D
RENEWED	R IH N UW D
RENEWED(2)	R IY N UW D
RENT	R EH N T
RENTAL	R EH N T AH L
REORGANIZATION	R IY AO R G AH N AH Z EY SH AH N
REPAIR	R IH P EH R
REPAY	R IY P EY
REPEATED	R IH P IY T IH D
REPEATED(2)	R IY P IY T AH D
REPEATED(3)	R IY P IY T IH D
REPEATEDLY	R IH P IY T IH D L IY
REPLACE	ER P L EY S
REPLACE(2)	R IY P L EY S
REPLACED	R IY P L EY S T
REPLACEMENT	R IH P L EY S M AH N T
REPORT	R IH P AO R T
REPORT(2)	R IY P AO R T
REPORTED	R IH P AO R T AH D
REPORTED(2)	R IY P AO R T AH D
REPORTEDLY	R IH P AO R T AH D L IY
REPORTEDLY(2)	R IY P AO R T AH D L IY
REPORTER	R IH P AO R T ER
REPORTERS	R IH P AO R T ER Z
REPORTING	R IH P AO R T IH NG
REPORTING(2)	R IY P AO R T IH NG
REPORTS	R IH P AO R T S
REPORTS(2)	R IY P AO R T S
REPRESENT	R EH P R AH Z EH N T
REPRESENT(2)	R EH P R IH Z EH N T
REPRESENTATIVE	R EH P R AH Z EH N AH T IH V
REPRESENTATIVE(2)	R EH P R AH Z EH N T AH T IH V
REPRESENTATIVE(3)	R EH P R IH Z EH N AH T IH V
REPRESENTATIVE(4)	R EH P R IH Z EH N T AH T IH V
REPRESENTATIVES	R EH P R AH Z EH N AH T IH V Z
REPRESENTATIVES(2)	R EH P R AH Z EH N T AH T IH V Z
REPRESENTATIVES(3)	R EH P R IH Z EH N AH T IH V Z
REPRESENTATIVES(4)	R EH P R IH Z EH N T AH T IH V Z
REPRESENTED	R EH P R AH Z EH N AH D
REPRESENTED(2)	R EH P R AH Z EH N T AH D
REPRESENTED(3)	R EH P R IH Z EH N IH D
REPRESENTED(4)	R EH P R IH Z EH N T IH D
REPRESENTING	R EH P R IH Z EH N IH NG
REPRESENTING(2)	R EH P R IH Z EH N T IH NG
REPRESENTS	R EH P R AH Z EH N T S
REPRESENTS(2)	R EH P R IH Z EH N T S
REPUBLIC	R IY P AH B L AH K
REPUBLIC(2)	R IY P AH B L IH K
REPUBLICAN	R IH P AH B L IH K AH N
REPUBLICAN(2)	R IY P AH B L AH K AH N
REPUBLICAN(3)	R IY P AH B L IH K AH N
REPUBLICANS	R IH P AH B L IH K AH N Z
REPUBLICANS(2)	R IY P AH B L AH K AH N Z
REPUBLICANS(3)	R IY P AH B L IH K AH N Z
REPUBLICBANK	R IY P AH B L IH K B AE NG K
REPURCHASE	R IY P ER CH AH S
REPUTATION	R EH P Y AH T EY SH AH N
REQUEST	R IH K W EH S T
REQUEST(2)	R IY K W EH S T
REQUESTED	R IH K W EH S T IH D
REQUESTED(2)	R IY K W EH S T AH D
REQUESTED(3)	R IY K W EH S T IH D
REQUESTS	R IH K W EH S
REQUESTS(2)	R IH K W EH S S
REQUESTS(3)	R IH K W EH S T S
REQUESTS(4)	R IY K W EH S
REQUESTS(5)	R IY K W EH S S
REQUESTS(6)	R IY K W EH S T S
REQUIRE	R IH K W AY ER
REQUIRE(2)	R IY K W AY ER
REQUIRE(3)	R IY K W AY R
REQUIRED	R IY K W AY ER D
REQUIRED(2)	R IY K W AY R D
REQUIREMENT	R IH K W AY R M AH N T
REQUIREMENTS	R IH K W AY R M AH N T S
REQUIRES	R IY K W AY ER Z
REQUIRES(2)	R IY K W AY R Z
REQUIRING	R IY K W AY ER IH NG
REQUIRING(2)	R IY K W AY R IH NG
RESCUE	R EH S K Y UW
RESEARCH	R IY S ER CH
RESEARCHERS	R IY S ER CH ER Z
RESERVE	R IH Z ER V
RESERVE(2)	R IY Z ER V
RESERVES	R IH Z ER V Z
RESERVES(2)	R IY Z ER V Z
RESIDENTIAL	R EH Z IH D EH N CH AH L
RESIDENTS	R EH Z IH D AH N T S
RESIGN	R IH Z AY N
RESIGN(2)	R IY S AY N
RESIGN(3)	R IY Z AY N
RESIGNATION	R EH Z AH G N EY SH AH N
RESIGNATION(2)	R EH Z IH G N EY SH AH N
RESIGNED	R IH Z AY N D
RESIGNED(2)	R IY S AY N D
RESIGNED(3)	R IY Z AY N D
RESIST	R IH Z IH S T
RESIST(2)	R IY Z IH S T
RESISTANCE	R IH Z IH S T AH N S
RESISTANCE(2)	R IY Z IH S T AH N S
RESOLUTION	R EH Z AH L UW SH AH N
RESOLVE	R IY Z AA L V
RESOLVED	R IY Z AA L V D
RESORT	R IH Z AO R T
RESORT(2)	R IY S AO R T
RESORT(3)	R IY Z AO R T
RESORTS	R IH Z AO R T S
RESORTS(2)	R IY S AO R T S
RESORTS(3)	R IY Z AO R T S
RESOURCE	R IY S AO R S
RESOURCES	R IY S AO R S IH Z
RESPECT	R IH S P EH K T
RESPECT(2)	R IY S P EH K T
RESPECTIVELY	R IH S P EH K T IH V L IY
RESPOND	R IH S P AA N D
RESPOND(2)	R IY S P AA N D
RESPONDED	R IH S P AA N D IH D
RESPONDED(2)	R IY S P AA N D AH D
RESPONDED(3)	R IY S P AA N D IH D
RESPONDING	R IH S P AA N D IH NG
RESPONDING(2)	R IY S P AA N D IH NG
RESPONSE	R IH S P AA N S
RESPONSE(2)	R IY S P AA N S
RESPONSIBILITIES	R IY S P AA N S AH B IH L AH T IY Z
RESPONSIBILITY	R IY S P AA N S AH B IH L AH T IY
RESPONSIBLE	R IY S P AA N S AH B AH L
REST	R EH S T
RESTATED	R IY S T EY T IH D
RESTAURANT	R EH S T ER AA N T
RESTAURANT(2)	R EH S T R AA N T
RESTAURANTS	R EH S T ER AA N T S
RESTAURANTS(2)	R EH S T R AA N T S
RESTORE	R IH S T AO R
RESTRICT	R IY S T R IH K T
RESTRICTED	R IY S T R IH K T AH D
RESTRICTED(2)	R IY S T R IH K T IH D
RESTRICTIONS	R IY S T R IH K SH AH N Z
RESTRUCTURE	R IY S T R AH K CH ER
RESTRUCTURING	R IY S T R AH K CH ER IH NG
RESULT	R IH Z AH L T
RESULT(2)	R IY Z AH L T
RESULTED	R IH Z AH L T IH D
RESULTED(2)	R IY Z AH L T AH D
RESULTED(3)	R IY Z AH L T IH D
RESULTING	R IH Z AH L T IH NG
RESULTING(2)	R IY Z AH L T IH NG
RESULTS	R IH Z AH L T S
RESULTS(2)	R IY Z AH L T S
RESUME	R EH Z AH M EY
RESUME(2)	R IH Z UW M
RESUME(3)	R IY Z UW M
RETAIL	R IY T EY L
RETAILER	R IY T EY L ER
RETAILERS	R IY T EY L ER Z
RETAILING	R IY T EY L IH NG
RETAIN	R IH T EY N
RETAIN(2)	R IY T EY N
RETAINED	R IH T EY N D
RETAINED(2)	R IY T EY N D
RETIRE	R IH T AY R
RETIRE(2)	R IY T AY ER
RETIRE(3)	R IY T AY R
RETIRED	R IH T AY R D
RETIRED(2)	R IY T AY ER D
RETIRED(3)	R IY T AY R D
RETIREMENT	R IH T AY ER M AH N T
RETIREMENT(2)	R IY T AY ER M AH N T
RETURN	R IH T ER N
RETURN(2)	R IY T ER N
RETURNED	R IH T ER N D
RETURNED(2)	R IY T ER N D
RETURNING	R IH T ER N IH NG
RETURNING(2)	R IY T ER N IH NG
RETURNS	R IH T ER N Z
RETURNS(2)	R IY T ER N Z
REVENUE	R EH V AH N UW
REVENUE(2)	R EH V AH N Y UW
REVENUES	R EH V AH N UW Z
REVENUES(2)	R EH V AH N Y UW Z
REVERSE	R IH V ER S
REVERSE(2)	R IY V ER S
REVERSED	R IH V ER S T
REVERSED(2)	R IY V ER S T
REVIEW	R IY V Y UW
REVIEWED	R IY V Y UW D
REVIEWING	R IY V Y UW IH NG
REVISED	R IH V AY Z D
REVISED(2)	R IY V AY Z D
REVISION	R IY V IH ZH AH N
REVLON	R EH V L AA N
REVOLUTION	R EH V AH L UW SH AH N
REVOLUTIONARY	R EH V AH L UW SH AH N EH R IY
REYNOLDS	R EH N AH L D Z
RHETORIC	R EH T ER IH K
RICE	R AY S
RICH	R IH CH
RICHARD	R IH CH ER D
RICHMOND	R IH CH M AH N D
RICO	R IY K OW
RIDE	R AY D
RIGHT	R AY T
RIGHTS	R AY T S
RING	R IH NG
RISE	R AY Z
RISEN	R IH Z AH N
RISES	R AY Z AH Z
RISES(2)	R AY Z IH Z
RISING	R AY Z IH NG
RISK	R IH S K
RISKS	R IH S K S
RISKY	R IH S K IY
RIVAL	R AY V AH L
RIVALS	R AY V AH L Z
RIVER	R IH V ER
ROAD	R OW D
ROBERT	R AA B ER T
ROBERTS	R AA B ER T S
ROBERTSON	R AA B ER T S AH N
ROBINS	R AA B AH N Z
ROBINSON	R AA B AH N S AH N
ROBUST	R OW B AH S T
ROCK	R AA K
ROCKET	R AA K AH T
ROCKWELL	R AA K W EH L
ROGER	R AA JH ER
ROGERS	R AA JH ER Z
ROLE	R OW L
ROLL	R OW L
RONALD	R AA N AH L D
ROOM	R UW M
ROOMS	R UW M Z
ROSE	R OW Z
ROSS	R AA S
ROSS(2)	R AO S
ROTHSCHILD	R AO TH S CH AY L D
ROUGHLY	R AH F L IY
ROUND	R AW N D
ROUTE	R AW T
ROUTE(2)	R UW T
ROUTES	R AW T S
ROUTES(2)	R UH T S
ROUTES(3)	R UW T S
ROUTINE	R UW T IY N
ROW	R OW
ROY	R OY
ROYAL	R OY AH L
RUBBER	R AH B ER
RUDMAN	R AH D M AH N
RULE	R UW L
RULED	R UW L D
RULES	R UW L Z
RULING	R UW L IH NG
RUMORED	R UW M ER D
RUMORS	R UW M ER Z
RUN	R AH N
RUNNING	R AH N IH NG
RUNS	R AH N Z
RURAL	R UH R AH L
RUSH	R AH SH
RUSSELL	R AH S AH L
RUSSIAN	R AH SH AH N
S.	EH S
S.'S	EH S IH Z
SAATCHI	S AA CH IY
SACHS	S AA K S
SACHS(2)	S AE K S
SAFE	S EY F
SAFETY	S EY F T IY
SAID	S EH D
SAINT	S EY N T
SALARIES	S AE L ER IY Z
SALARY	S AE L ER IY
SALE	S EY L
SALES	S EY L Z
SALOMON	S AE L AH M AH N
SALT	S AO L T
SAM	S AE M
SAME	S EY M
SAMUEL	S AE M Y UW L
SAN	S AE N
SANCTIONS	S AE NG K SH AH N Z
SANCTIONS(2)	S AE NG SH AH N Z
SANDINISTA	S AE N D IH N IH S T AH
SANDINISTA(2)	S AE N D IH N IY S T AH
SANDINISTAS	S AE N D IH N IY S T AH Z
SANTA	S AE N AH
SANTA(2)	S AE N T AH
SATELLITE	S AE T AH L AY T
SATISFIED	S AE T AH S F AY D
SATISFIED(2)	S AE T IH S F AY D
SATISFY	S AE T AH S F AY
SATISFY(2)	S AE T IH S F AY
SATURDAY	S AE T ER D IY
SATURDAY(2)	S AE T IH D EY
SAUDI	S AO D IY
SAUDI(2)	S AW D IY
SAVE	S EY V
SAVING	S EY V IH NG
SAVINGS	S EY V IH NG Z
SAW	S AO
SAY	S EY
SAYING	S EY IH NG
SAYS	S EH Z
SAYS(2)	S IH Z
SCALE	S K EY L
SCANDAL	S K AE N D AH L
SCENE	S IY N
SCHEDULE	S K EH JH UH L
SCHEDULE(2)	S K EH JH UW L
SCHEDULED	S K EH JH UH L D
SCHEDULED(2)	S K EH JH UW L D
SCHEME	S K IY M
SCHOOL	S K UW L
SCHOOLS	S K UW L Z
SCIENCE	S AY AH N S
SCIENCES	S AY AH N S AH Z
SCIENCES(2)	S AY AH N S IH Z
SCIENTIFIC	S AY AH N T IH F IH K
SCIENTIST	S AY AH N T IH S T
SCIENTISTS	S AY AH N T IH S
SCIENTISTS(2)	S AY AH N T IH S S
SCIENTISTS(3)	S AY AH N T IH S T S
SCIENTISTS(4)	S AY N T IH S
SCIENTISTS(5)	S AY N T IH S S
SCIENTISTS(6)	S AY N T IH S T S
SCORE	S K AO R
SCORES	S K AO R Z
SCOTT	S K AA T
SCREEN	S K R IY N
SCRUTINY	S K R UW T AH N IY
SEA	S IY
SEABROOK	S IY B R UH K
SEARCH	S ER CH
SEARS	S IH R Z
SEASON	S IY Z AH N
SEASONAL	S IY Z AH N AH L
SEASONALLY	S IY Z AH N AH L IY
SEASONALLY(2)	S IY Z N AH L IY
SEAT	S IY T
SEATS	S IY T S
SEATTLE	S IY AE T AH L
SECOND	S EH K AH N
SECOND(2)	S EH K AH N D
SECONDARY	S EH K AH N D EH R IY
SECONDS	S EH K AH N D Z
SECONDS(2)	S EH K AH N Z
SECRET	S IY K R AH T
SECRET(2)	S IY K R IH T
SECRETARY	S EH K R AH T EH R IY
SECTION	S EH K SH AH N
SECTOR	S EH K T ER
SECTORS	S EH K T ER Z
SECURE	S IH K Y UH R
SECURED	S IH K Y UH R D
SECURITIES	S IH K Y UH R AH T IY Z
SECURITY	S IH K Y UH R AH T IY
SEE	S IY
SEEING	S IY IH NG
SEEK	S IY K
SEEKING	S IY K IH NG
SEEKS	S IY K S
SEEM	S IY M
SEEMED	S IY M D
SEEMS	S IY M Z
SEEN	S IY N
SEES	S IY Z
SEGMENT	S EH G M AH N T
SEGMENT(2)	S EH G M EH N T
SEIZED	S IY Z D
SELECTED	S AH L EH K T AH D
SELECTED(2)	S AH L EH K T IH D
SELECTION	S AH L EH K SH AH N
SELF	S EH L F
SELL	S EH L
SELLER	S EH L ER
SELLERS	S EH L ER Z
SELLING	S EH L IH NG
SELLS	S EH L Z
SEMICONDUCTOR	S EH M AY K AH N D AH K T ER
SEMICONDUCTOR(2)	S EH M IH K AH N D AH K T ER
SEMICONDUCTOR(3)	S EH M IY K AH N D AH K T ER
SENATE	S EH N AH T
SENATE(2)	S EH N IH T
SENATOR	S EH N AH T ER
SENATORS	S EH N AH T ER Z
SEND	S EH N D
SENDING	S EH N D IH NG
SENIOR	S IY N Y ER
SENSE	S EH N S
SENSITIVE	S EH N S AH T IH V
SENSITIVE(2)	S EH N S IH T IH V
SENT	S EH N T
SENTENCE	S EH N T AH N S
SENTENCED	S EH N T AH N S T
SENTIMENT	S EH N AH M AH N T
SENTIMENT(2)	S EH N T AH M AH N T
SEOUL	S OW L
SEPARATE	S EH P ER EY T
SEPARATE(2)	S EH P ER IH T
SEPARATE(3)	S EH P R AH T
SEPARATELY	S EH P ER AH T L IY
SEPARATELY(2)	S EH P R AH T L IY
SEPTEMBER	S EH P T EH M B ER
SERIES	S IH R IY Z
SERIOUS	S IH R IY AH S
SERIOUSLY	S IH R IY AH S L IY
SERVE	S ER V
SERVED	S ER V D
SERVES	S ER V Z
SERVICE	S ER V AH S
SERVICE(2)	S ER V IH S
SERVICES	S ER V AH S AH Z
SERVICES(2)	S ER V IH S IH Z
SERVING	S ER V IH NG
SESSION	S EH SH AH N
SESSIONS	S EH SH AH N Z
SET	S EH T
SETS	S EH T S
SETTING	S EH T IH NG
SETTLE	S EH T AH L
SETTLED	S EH T AH L D
SETTLEMENT	S EH T AH L M AH N T
SETTLEMENTS	S EH T AH L M AH N T S
SEVEN	S EH V AH N
SEVENTEEN	S EH V AH N T IY N
SEVENTEENTH	S EH V AH N T IY N TH
SEVENTH	S EH V AH N TH
SEVENTIES	S EH V AH N IY Z
SEVENTIES(2)	S EH V AH N T IY Z
SEVENTY	S EH V AH N IY
SEVENTY(2)	S EH V AH N T IY
SEVERAL	S EH V ER AH L
SEVERAL(2)	S EH V R AH L
SEVERE	S AH V IH R
SEVERELY	S AH V IH R L IY
SEX	S EH K S
SEXUAL	S EH K SH UW AH L
SHAMROCK	SH AE M R AA K
SHAPE	SH EY P
SHARE	SH EH R
SHARED	SH EH R D
SHAREHOLDER	SH EH R HH OW L D ER
SHAREHOLDERS	SH EH R HH OW L D ER Z
SHARES	SH EH R Z
SHARING	SH EH R IH NG
SHARP	SH AA R P
SHARPLY	SH AA R P L IY
SHE	SH IY
SHE'S	SH IY Z
SHEARSON	SH IH R S AH N
SHED	SH EH D
SHEET	SH IY T
SHELF	SH EH L F
SHELL	SH EH L
SHIELD	SH IY L D
SHIFT	SH IH F T
SHIP	SH IH P
SHIPMENTS	SH IH P M AH N T S
SHIPPED	SH IH P T
SHIPPING	SH IH P IH NG
SHIPS	SH IH P S
SHOCK	SH AA K
SHOE	SH UW
SHOES	SH UW Z
SHOP	SH AA P
SHOPPING	SH AA P IH NG
SHOPS	SH AA P S
SHORT	SH AO R T
SHORTAGE	SH AO R T AH JH
SHORTAGE(2)	SH AO R T IH JH
SHORTAGES	SH AO R T AH JH AH Z
SHORTAGES(2)	SH AO R T IH JH IH Z
SHORTLY	SH AO R T L IY
SHOT	SH AA T
SHOULD	SH UH D
SHOULDN'T	SH UH D AH N T
SHOW	SH OW
SHOWED	SH OW D
SHOWING	SH OW IH NG
SHOWN	SH OW N
SHOWS	SH OW Z
SHRINKING	SH R IH NG K IH NG
SHULTZ	SH UH L T S
SHUT	SH AH T
SHUTTLE	SH AH T AH L
SICK	S IH K
SIDE	S AY D
SIDES	S AY D Z
SIEMENS	S IY M AH N Z
SIGN	S AY N
SIGNAL	S IH G N AH L
SIGNALS	S IH G N AH L Z
SIGNED	S AY N D
SIGNIFICANT	S AH G N IH F IH K AH N T
SIGNIFICANT(2)	S IH G N IH F IH K AH N T
SIGNIFICANTLY	S IH G N IH F IH K AH N T L IY
SIGNING	S AY N IH NG
SIGNS	S AY N Z
SILVER	S IH L V ER
SIMILAR	S IH M AH L ER
SIMILARLY	S IH M AH L ER L IY
SIMON	S AY M AH N
SIMPLE	S IH M P AH L
SIMPLY	S IH M P L IY
SINCE	S IH N S
SINGAPORE	S IH NG AH P AO R
SINGER	S IH NG ER
SINGLE	S IH NG G AH L
SIR	S ER
SIT	S IH T
SITE	S AY T
SITES	S AY T S
SITTING	S IH T IH NG
SITUATION	S IH CH UW EY SH AH N
SITUATIONS	S IH CH UW EY SH AH N Z
SIX	S IH K S
SIXTEEN	S IH K S T IY N
SIXTEENTH	S IH K S T IY N TH
SIXTEENTHS	S IH K S T IY N TH S
SIXTH	S IH K S TH
SIXTIES	S IH K S T IY Z
SIXTY	S IH K S T IY
SIZABLE	S AY Z AH B AH L
SIZE	S AY Z
SIZED	S AY Z D
SKEPTICAL	S K EH P T AH K AH L
SKEPTICAL(2)	S K EH P T IH K AH L
SKILLS	S K IH L Z
SKIN	S K IH N
SLATED	S L EY T IH D
SLID	S L IH D
SLIDE	S L AY D
SLIGHT	S L AY T
SLIGHTLY	S L AY T L IY
SLIPPED	S L IH P T
SLOW	S L OW
SLOWDOWN	S L OW D AW N
SLOWED	S L OW D
SLOWER	S L OW ER
SLOWING	S L OW IH NG
SLOWLY	S L OW L IY
SLUGGISH	S L AH G IH SH
SLUMP	S L AH M P
SMALL	S M AO L
SMALLER	S M AO L ER
SMART	S M AA R T
SMITH	S M IH TH
SMOKE	S M OW K
SMOKING	S M OW K IH NG
SO	S OW
SOARED	S AO R D
SOARING	S AO R IH NG
SOCIAL	S OW SH AH L
SOCIALIST	S OW SH AH L AH S T
SOCIALIST(2)	S OW SH AH L IH S T
SOCIETY	S AH S AY AH T IY
SOFT	S AA F T
SOFT(2)	S AO F T
SOFTWARE	S AO F T W EH R
SOFTWARE(2)	S AO F W EH R
SOLD	S OW L D
SOLDIERS	S OW L JH ER Z
SOLE	S OW L
SOLID	S AA L AH D
SOLIDARITY	S AA L AH D EH R AH T IY
SOLUTION	S AH L UW SH AH N
SOLUTIONS	S AH L UW SH AH N Z
SOLVE	S AA L V
SOME	S AH M
SOMEBODY	S AH M B AA D IY
SOMEBODY(2)	S AH M B AH D IY
SOMEHOW	S AH M HH AW
SOMEONE	S AH M W AH N
SOMETHING	S AH M TH IH NG
SOMETIMES	S AH M T AY M Z
SOMEWHAT	S AH M HH W AH T
SOMEWHAT(2)	S AH M W AH T
SON	S AH N
SONS	S AH N Z
SONY	S OW N IY
SOON	S UW N
SOONER	S UW N ER
SOPHISTICATED	S AH F IH S T AH K EY T IH D
SOPHISTICATED(2)	S AH F IH S T IH K EY T AH D
SORT	S AO R T
SOUGHT	S AO T
SOUND	S AW N D
SOUNDS	S AW N D Z
SOUNDS(2)	S AW N Z
SOURCE	S AO R S
SOURCES	S AO R S AH Z
SOUTH	S AW TH
SOUTHEAST	S AW TH IY S T
SOUTHERN	S AH DH ER N
SOUTHLAND	S AW TH L AE N D
SOUTHWEST	S AW TH W EH S T
SOVIET	S OW V IY AH T
SOVIET(2)	S OW V IY EH T
SOVIETS	S OW V IY EH T S
SOYBEAN	S OY B IY N
SOYBEANS	S OY B IY N Z
SPACE	S P EY S
SPAIN	S P EY N
SPANISH	S P AE N IH SH
SPARKED	S P AA R K T
SPEAK	S P IY K
SPEAKER	S P IY K ER
SPEAKING	S P IY K IH NG
SPECIAL	S P EH SH AH L
SPECIALIST	S P EH SH AH L AH S T
SPECIALIST(2)	S P EH SH AH L IH S T
SPECIALISTS	S P EH SH AH L AH S T S
SPECIALISTS(2)	S P EH SH AH L IH S
SPECIALISTS(3)	S P EH SH AH L IH S S
SPECIALISTS(4)	S P EH SH AH L IH S T S
SPECIALTY	S P EH SH AH L T IY
SPECIALTY(2)	S P EY SH AH L T IY
SPECIFIC	S P AH S IH F IH K
SPECIFIC(2)	S P IH S IH F IH K
SPECIFICALLY	S P AH S IH F IH K L IY
SPECIFY	S P EH S AH F AY
SPECULATED	S P EH K Y AH L EY T AH D
SPECULATED(2)	S P EH K Y AH L EY T IH D
SPECULATION	S P EH K Y AH L EY SH AH N
SPECULATIVE	S P EH K Y AH L AH T IH V
SPECULATORS	S P EH K Y AH L EY T ER Z
SPEECH	S P IY CH
SPEED	S P IY D
SPEND	S P EH N D
SPENDING	S P EH N D IH NG
SPENT	S P EH N T
SPIRIT	S P IH R AH T
SPIRIT(2)	S P IH R IH T
SPLIT	S P L IH T
SPOKE	S P OW K
SPOKESMAN	S P OW K S M AH N
SPOKESWOMAN	S P OW K S W UH M AH N
SPONSORED	S P AA N S ER D
SPORT	S P AO R T
SPORTS	S P AO R T S
SPOT	S P AA T
SPOTS	S P AA T S
SPREAD	S P R EH D
SPRING	S P ER IH NG
SPRING(2)	S P R IH NG
SPUR	S P ER
SPURRED	S P ER D
SQUARE	S K W EH R
SQUEEZE	S K W IY Z
STABILITY	S T AH B IH L IH T IY
STABILIZE	S T EY B AH L AY Z
STABLE	S T EY B AH L
STAFF	S T AE F
STAFFERS	S T AE F ER Z
STAGE	S T EY JH
STAKE	S T EY K
STAKES	S T EY K S
STAMFORD	S T AE M F ER D
STANCE	S T AE N S
STAND	S T AE N D
STANDARD	S T AE N D ER D
STANDARDS	S T AE N D ER D Z
STANDING	S T AE N D IH NG
STANDS	S T AE N D Z
STANLEY	S T AE N L IY
STAR	S T AA R
STARS	S T AA R Z
START	S T AA R T
STARTED	S T AA R T AH D
STARTED(2)	S T AA R T IH D
STARTING	S T AA R T IH NG
STARTS	S T AA R T S
STATE	S T EY T
STATE'S	S T EY T S
STATED	S T EY T AH D
STATED(2)	S T EY T IH D
STATEMENT	S T EY T M AH N T
STATEMENTS	S T EY T M AH N T S
STATES	S T EY T S
STATION	S T EY SH AH N
STATIONS	S T EY SH AH N Z
STATISTICAL	S T AH T IH S T IH K AH L
STATISTICS	S T AH T IH S T IH K S
STATUS	S T AE T AH S
STATUS(2)	S T EY T AH S
STATUTE	S T AE CH UW T
STAY	S T EY
STAYED	S T EY D
STEADILY	S T EH D AH L IY
STEADY	S T EH D IY
STEAM	S T IY M
STEARNS	S T ER N Z
STEEL	S T IY L
STEEP	S T IY P
STEINBERG	S T AY N B ER G
STEM	S T EH M
STEMMING	S T EH M IH NG
STEP	S T EH P
STEPHEN	S T EH F AH N
STEPHEN(2)	S T IY V AH N
STEPPED	S T EH P T
STEPS	S T EH P S
STERLING	S T ER L IH NG
STEVEN	S T IY V AH N
STEVENS	S T IY V AH N Z
STICK	S T IH K
STILL	S T IH L
STIMULATE	S T IH M Y AH L EY T
STOCK	S T AA K
STOCKHOLDERS	S T AA K HH OW L D ER Z
STOCKHOLM	S T AA K HH OW L M
STOCKS	S T AA K S
STONE	S T OW N
STOOD	S T UH D
STOP	S T AA P
STOPPED	S T AA P T
STORAGE	S T AO R AH JH
STORAGE(2)	S T AO R IH JH
STORE	S T AO R
STORES	S T AO R Z
STORIES	S T AO R IY Z
STORY	S T AO R IY
STRAIGHT	S T R EY T
STRATEGIC	S T R AH T IY JH IH K
STRATEGIES	S T R AE T AH JH IY Z
STRATEGIST	S T R AE T IH JH IH S T
STRATEGY	S T R AE T AH JH IY
STREET	S T R IY T
STREET'S	S T R IY T S
STREETS	S T R IY T S
STRENGTH	S T R EH NG K TH
STRENGTH(2)	S T R EH NG TH
STRENGTHEN	S T R EH NG TH AH N
STRESS	S T R EH S
STRESSED	S T R EH S T
STRIKE	S T R AY K
STRIKES	S T R AY K S
STRIKING	S T R AY K IH NG
STRING	S T R IH NG
STRIP	S T R IH P
STRONG	S T R AO NG
STRONGER	S T R AO NG ER
STRONGER(2)	S T R AO NG G ER
STRONGEST	S T R AO NG G AH S T
STRONGLY	S T R AO NG L IY
STRUCK	S T R AH K
STRUCTURE	S T R AH K CH ER
STRUGGLE	S T R AH G AH L
STRUGGLING	S T R AH G AH L IH NG
STRUGGLING(2)	S T R AH G L IH NG
STUCK	S T AH K
STUDENT	S T UW D AH N T
STUDENTS	S T UW D AH N T S
STUDIED	S T AH D IY D
STUDIES	S T AH D IY Z
STUDIO	S T UW D IY OW
STUDY	S T AH D IY
STUDYING	S T AH D IY IH NG
STUFF	S T AH F
STYLE	S T AY L
SUBCOMMITTEE	S AH B K AH M IH T IY
SUBJECT	S AH B JH EH K T
SUBJECT(2)	S AH B JH IH K T
SUBMIT	S AH B M IH T
SUBMITTED	S AH B M IH T AH D
SUBORDINATED	S AH B AO R D AH N EY T IH D
SUBSCRIBERS	S AH B S K R AY B ER Z
SUBSEQUENT	S AH B S AH K W AH N T
SUBSEQUENTLY	S AH B S AH K W AH N T L IY
SUBSIDIARIES	S AH B S IH D IY EH R IY Z
SUBSIDIARY	S AH B S IH D IY EH R IY
SUBSIDIES	S AH B S AH D IY Z
SUBSIDIES(2)	S AH B S IH D IY Z
SUBSTANCE	S AH B S T AH N S
SUBSTANTIAL	S AH B S T AE N CH AH L
SUBSTANTIAL(2)	S AH B S T AE N SH AH L
SUBSTANTIALLY	S AH B S T AE N CH AH L IY
SUBSTANTIALLY(2)	S AH B S T AE N SH AH L IY
SUBURBAN	S AH B ER B AH N
SUCCEED	S AH K S IY D
SUCCEEDED	S AH K S IY D AH D
SUCCEEDED(2)	S AH K S IY D IH D
SUCCEEDING	S AH K S IY D IH NG
SUCCEEDS	S AH K S IY D Z
SUCCESS	S AH K S EH S
SUCCESSFUL	S AH K S EH S F AH L
SUCCESSFULLY	S AH K S EH S F AH L IY
SUCCESSOR	S AH K S EH S ER
SUCH	S AH CH
SUDDEN	S AH D AH N
SUDDENLY	S AH D AH N L IY
SUE	S UW
SUED	S UW D
SUFFER	S AH F ER
SUFFERED	S AH F ER D
SUFFERING	S AH F ER IH NG
SUFFERING(2)	S AH F R IH NG
SUFFICIENT	S AH F IH SH AH N T
SUGAR	SH UH G ER
SUGGEST	S AH G JH EH S T
SUGGESTED	S AH G JH EH S T AH D
SUGGESTED(2)	S AH G JH EH S T IH D
SUGGESTING	S AH G JH EH S T IH NG
SUGGESTS	S AH G JH EH S
SUGGESTS(2)	S AH G JH EH S S
SUGGESTS(3)	S AH G JH EH S T S
SUIT	S UW T
SUITOR	S UW T ER
SUITS	S UW T S
SULLIVAN	S AH L AH V AH N
SULLIVAN(2)	S AH L IH V AH N
SUM	S AH M
SUMMER	S AH M ER
SUMMIT	S AH M AH T
SUMMIT(2)	S AH M IH T
SUN	S AH N
SUNDAY	S AH N D EY
SUNDAY(2)	S AH N D IY
SUPER	S UW P ER
SUPERIOR	S UW P IH R IY ER
SUPERMARKET	S UW P ER M AA R K IH T
SUPERMARKETS	S UW P ER M AA R K IH T S
SUPPLIED	S AH P L AY D
SUPPLIER	S AH P L AY ER
SUPPLIERS	S AH P L AY ER Z
SUPPLIES	S AH P L AY Z
SUPPLY	S AH P L AY
SUPPORT	S AH P AO R T
SUPPORTED	S AH P AO R T AH D
SUPPORTED(2)	S AH P AO R T IH D
SUPPORTERS	S AH P AO R T ER Z
SUPPORTING	S AH P AO R T IH NG
SUPPORTS	S AH P AO R T S
SUPPOSED	S AH P OW Z D
SUPREME	S AH P R IY M
SUPREME(2)	S ER P R IY M
SURE	SH UH R
SURELY	SH UH R L IY
SURFACE	S ER F AH S
SURGE	S ER JH
SURGED	S ER JH D
SURGERY	S ER JH ER IY
SURPLUS	S ER P L AH S
SURPRISE	S AH P R AY Z
SURPRISE(2)	S ER P R AY Z
SURPRISED	S AH P R AY Z D
SURPRISED(2)	S ER P R AY Z D
SURPRISING	S AH P R AY Z IH NG
SURPRISING(2)	S ER P R AY Z IH NG
SURPRISINGLY	S AH P R AY Z IH NG L IY
SURPRISINGLY(2)	S ER P R AY Z IH NG L IY
SURROUNDING	S ER AW N D IH NG
SURVEY	S ER V EY
SURVEYED	S ER V EY D
SURVEYS	S ER V EY Z
SURVIVE	S ER V AY V
SUSPECT	S AH S P EH K T
SUSPECTED	S AH S P EH K T AH D
SUSPECTED(2)	S AH S P EH K T IH D
SUSPENDED	S AH S P EH N D AH D
SUSPENDED(2)	S AH S P EH N D IH D
SUSPENSION	S AH S P EH N SH AH N
SUSTAINED	S AH S T EY N D
SWAP	S W AA P
SWEDEN	S W IY D AH N
SWEDISH	S W IY D IH SH
SWEEPING	S W IY P IH NG
SWEETENED	S W IY T AH N D
SWISS	S W IH S
SWITCH	S W IH CH
SWITZERLAND	S W IH T S ER L AH N D
SYDNEY	S IH D N IY
SYMBOL	S IH M B AH L
SYNDICATE	S IH N D AH K EY T
SYNDICATE(2)	S IH N D IH K AH T
SYNDROME	S IH N D R OW M
SYSTEM	S IH S T AH M
SYSTEMS	S IH S T AH M Z
T.	T IY
T.'S	T IY Z
TABLE	T EY B AH L
TACTICS	T AE K T IH K S
TAIWAN	T AY W AA N
TAKE	T EY K
TAKEN	T EY K AH N
TAKEOVER	T EY K OW V ER
TAKEOVERS	T EY K OW V ER Z
TAKES	T EY K S
TAKING	T EY K IH NG
TALENT	T AE L AH N T
TALK	T AO K
TALKED	T AO K T
TALKING	T AO K IH NG
TALKS	T AO K S
TANK	T AE NG K
TAPE	T EY P
TARGET	T AA R G AH T
TARGET(2)	T ER G AH T
TARGETED	T AA R G AH T IH D
TARGETS	T AA R G AH T S
TARIFFS	T EH R AH F S
TASK	T AE S K
TASTE	T EY S T
TAX	T AE K S
TAXABLE	T AE K S AH B AH L
TAXES	T AE K S AH Z
TAXES(2)	T AE K S IH Z
TAXPAYERS	T AE K S P EY ER Z
TAYLOR	T EY L ER
TEACHER	T IY CH ER
TEACHERS	T IY CH ER Z
TEACHING	T IY CH IH NG
TEAM	T IY M
TEAMS	T IY M Z
TECH	T EH K
TECHNICAL	T EH K N IH K AH L
TECHNIQUE	T EH K N IY K
TECHNIQUES	T EH K N IY K S
TECHNOLOGICAL	T EH K N AH L AA JH IH K AH L
TECHNOLOGIES	T EH K N AA L AH JH IY Z
TECHNOLOGY	T EH K N AA L AH JH IY
TEEN	T IY N
TEHRAN	T EY R AA N
TELECOMMUNICATIONS	T EH L AH K AH M Y UW N AH K EY SH AH N Z
TELEGRAPH	T EH L AH G R AE F
TELEPHONE	T EH L AH F OW N
TELERATE	T EH L ER EY T
TELEVISION	T EH L AH V IH ZH AH N
TELL	T EH L
TELLING	T EH L IH NG
TELLS	T EH L Z
TEMPORARILY	T EH M P ER EH R AH L IY
TEMPORARY	T EH M P ER EH R IY
TEN	T EH N
TEND	T EH N D
TENDER	T EH N D ER
TENDERED	T EH N D ER D
TENNESSEE	T EH N AH S IY
TENNIS	T EH N AH S
TENNIS(2)	T EH N IH S
TENSIONS	T EH N CH AH N Z
TENTATIVE	T EH N AH T IH V
TENTATIVE(2)	T EH N T AH T IH V
TENTATIVELY	T EH N T AH T IH V L IY
TENTATIVELY(2)	T EH N T AH V L IY
TENTH	T EH N TH
TERM	T ER M
TERMS	T ER M Z
TERRITORY	T EH R IH T AO R IY
TEST	T EH S T
TESTED	T EH S T AH D
TESTED(2)	T EH S T IH D
TESTIFIED	T EH S T AH F AY D
TESTIMONY	T EH S T AH M OW N IY
TESTING	T EH S T IH NG
TESTS	T EH S T S
TEXACO	T EH K S AH K OW
TEXACO'S	T EH K S AH K OW Z
TEXAS	T EH K S AH S
TEXTILE	T EH K S T AY L
THAN	DH AE N
THAN(2)	DH AH N
THANKS	TH AE NG K S
THAT	DH AE T
THAT(2)	DH AH T
THAT'S	DH AE T S
THATCHER	TH AE CH ER
THE	DH AH
THE(2)	DH IY
THEATER	TH IY AH T ER
THEIR	DH EH R
THEM	DH AH M
THEM(2)	DH EH M
THEME	TH IY M
THEMSELVES	DH AH M S EH L V Z
THEMSELVES(2)	DH EH M S EH L V Z
THEN	DH EH N
THEORY	TH IH R IY
THEORY(2)	TH IY ER IY
THERE	DH EH R
THERE'S	DH EH R Z
THEREFORE	DH EH R F AO R
THESE	DH IY Z
THEY	DH EY
THEY'LL	DH EY L
THEY'RE	DH EH R
THEY'VE	DH EY V
THIN	TH IH N
THING	TH IH NG
THINGS	TH IH NG Z
THINK	TH IH NG K
THINKING	TH IH NG K IH NG
THINKS	TH IH NG K S
THIRD	TH ER D
THIRDS	TH ER D Z
THIRTEEN	TH ER T IY N
THIRTEENTH	TH ER T IY N TH
THIRTIES	TH ER T IY Z
THIRTIETH	TH ER T IY AH TH
THIRTIETH(2)	TH ER T IY IH TH
THIRTY	TH ER D IY
THIRTY(2)	TH ER T IY
THIS	DH IH S
THOMAS	T AA M AH S
THOMPSON	T AA M P S AH N
THOMPSON(2)	T AA M S AH N
THOMSON	T AA M S AH N
THOSE	DH OW Z
THOUGH	DH OW
THOUGHT	TH AO T
THOUSAND	TH AW Z AH N
THOUSAND(2)	TH AW Z AH N D
THOUSANDS	TH AW Z AH N D Z
THOUSANDS(2)	TH AW Z AH N Z
THREAT	TH R EH T
THREATENED	TH R EH T AH N D
THREATENING	TH R EH T AH N IH NG
THREATENING(2)	TH R EH T N IH NG
THREATS	TH R EH T S
THREE	TH R IY
THRIFT	TH R IH F T
THRIFTS	TH R IH F S
THRIFTS(2)	TH R IH F T S
THROUGH	TH R UW
THROUGHOUT	TH R UW AW T
THROW	TH R OW
THURSDAY	TH ER Z D EY
THURSDAY(2)	TH ER Z D IY
THUS	DH AH S
TICKET	T IH K AH T
TICKET(2)	T IH K IH T
TICKETS	T IH K AH T S
TICKETS(2)	T IH K IH T S
TIE	T AY
TIED	T AY D
TIES	T AY Z
TIGHT	T AY T
TIGHTEN	T AY T AH N
TIGHTENING	T AY T AH N IH NG
TIGHTENING(2)	T AY T N IH NG
TIME	T AY M
TIMES	T AY M Z
TIMING	T AY M IH NG
TINY	T AY N IY
TIRE	T AY ER
TITLE	T AY T AH L
TO	T AH
TO(2)	T IH
TO(3)	T UW
TOBACCO	T AH B AE K OW
TODAY	T AH D EY
TODAY(2)	T UW D EY
TODAY'S	T AH D EY Z
TODAY'S(2)	T UW D EY Z
TOGETHER	T AH G EH DH ER
TOKYO	T OW K IY OW
TOLD	T OW L D
TOLL	T OW L
TOM	T AA M
TOMORROW	T AH M AA R OW
TOMORROW(2)	T UW M AA R OW
TON	T AH N
TONE	T OW N
TONS	T AH N Z
TOO	T UW
TOOK	T UH K
TOOL	T UW L
TOOLS	T UW L Z
TOP	T AA P
TOP(2)	T AO P
TORONTO	T AO R AA N T OW
TORONTO(2)	T ER AA N T OW
TOSHIBA	T OW SH IY B AH
TOTAL	T OW T AH L
TOTALED	T OW T AH L D
TOTALING	T OW T AH L IH NG
TOTALLY	T OW T AH L IY
TOUCH	T AH CH
TOUGH	T AH F
TOUGHER	T AH F ER
TOUR	T UH R
TOWARD	T AH W AO R D
TOWARD(2)	T AO R D
TOWER	T AW ER
TOWN	T AW N
TOXIC	T AA K S IH K
TOY	T OY
TOYOTA	T OW Y OW T AH
TOYS	T OY Z
TRACK	T R AE K
TRACKS	T R AE K S
TRADE	T R EY D
TRADED	T R EY D IH D
TRADER	T R EY D ER
TRADERS	T R EY D ER Z
TRADES	T R EY D Z
TRADING	T R EY D IH NG
TRADITION	T R AH D IH SH AH N
TRADITIONAL	T R AH D IH SH AH N AH L
TRADITIONALLY	T R AH D IH SH AH N AH L IY
TRADITIONALLY(2)	T R AH D IH SH N AH L IY
TRAFFIC	T R AE F IH K
TRAIN	T R EY N
TRAINED	T R EY N D
TRAINING	T R EY N IH NG
TRANS	T R AE N Z
TRANSACTION	T R AE N Z AE K SH AH N
TRANSACTIONS	T R AE N Z AE K SH AH N Z
TRANSFER	T R AE N S F ER
TRANSFERRED	T R AE N S F ER D
TRANSFERS	T R AE N S F ER Z
TRANSITION	T R AE N Z IH SH AH N
TRANSMISSION	T R AE N S M IH SH AH N
TRANSMISSION(2)	T R AE N Z M IH SH AH N
TRANSPORT	T R AE N S P AO R T
TRANSPORTATION	T R AE N S P ER T EY SH AH N
TRAVEL	T R AE V AH L
TRAVELERS	T R AE V AH L ER Z
TRAVELERS(2)	T R AE V L ER Z
TREASURER	T R EH ZH ER ER
TREASURY	T R EH ZH ER IY
TREASURY'S	T R EH ZH ER IY Z
TREAT	T R IY T
TREATED	T R IY T AH D
TREATED(2)	T R IY T IH D
TREATMENT	T R IY T M AH N T
TREATY	T R IY T IY
TREES	T R IY Z
TREMENDOUS	T R AH M EH N D AH S
TREMENDOUS(2)	T R IH M EH N D AH S
TREND	T R EH N D
TRENDS	T R EH N D Z
TRENDS(2)	T R EH N Z
TRIAL	T R AY AH L
TRIAL(2)	T R AY L
TRIALS	T R AY AH L Z
TRIALS(2)	T R AY L Z
TRIED	T R AY D
TRIES	T R AY Z
TRIGGER	T R IH G ER
TRIGGERED	T R IH G ER D
TRILLION	T R IH L Y AH N
TRIM	T R IH M
TRIP	T R IH P
TRIPLE	T R IH P AH L
TROOPS	T R UW P S
TROUBLE	T R AH B AH L
TROUBLED	T R AH B AH L D
TROUBLES	T R AH B AH L Z
TRUCK	T R AH K
TRUCKS	T R AH K S
TRUE	T R UW
TRULY	T R UW L IY
TRUMP	T R AH M P
TRUST	T R AH S T
TRUSTEE	T R AH S T IY
TRUSTS	T R AH S T S
TRUTH	T R UW TH
TRY	T R AY
TRYING	T R AY IH NG
TRYING(2)	T R AY NG
TUESDAY	T UW Z D EY
TUESDAY(2)	T UW Z D IY
TUESDAY(3)	T Y UW Z D EY
TUESDAY'S	T UW Z D EY Z
TUESDAY'S(2)	T UW Z D IY Z
TUESDAY'S(3)	T Y UW Z D EY Z
TUMBLED	T AH M B AH L D
TURKEY	T ER K IY
TURMOIL	T ER M OY L
TURN	T ER N
TURNAROUND	T ER N ER AW N D
TURNED	T ER N D
TURNER	T ER N ER
TURNING	T ER N IH NG
TURNOVER	T ER N OW V ER
TURNS	T ER N Z
TWELFTH	T W EH L F TH
TWELVE	T W EH L V
TWENTIETH	T W EH N IY AH TH
TWENTIETH(2)	T W EH N IY IH TH
TWENTIETH(3)	T W EH N T IY AH TH
TWENTIETH(4)	T W EH N T IY IH TH
TWENTY	T W EH N IY
TWENTY(2)	T W EH N T IY
TWICE	T W AY S
TWO	T UW
TYPE	T AY P
TYPES	T AY P S
TYPICAL	T IH P AH K AH L
TYPICAL(2)	T IH P IH K AH L
TYPICALLY	T IH P IH K AH L IY
TYPICALLY(2)	T IH P IH K L IY
U.	Y UW
ULTIMATE	AH L T AH M AH T
ULTIMATELY	AH L T AH M AH T L IY
UNABLE	AH N EY B AH L
UNCERTAIN	AH N S ER T AH N
UNCERTAINTY	AH N S ER T AH N T IY
UNCHANGED	AH N CH EY N JH D
UNCLEAR	AH N K L IH R
UNDER	AH N D ER
UNDERLYING	AH N D ER L AY IH NG
UNDERSTAND	AH N D ER S T AE N D
UNDERSTANDING	AH N D ER S T AE N D IH NG
UNDERSTOOD	AH N D ER S T UH D
UNDERWRITER	AH N D ER R AY T ER
UNDERWRITERS	AH N D ER R AY T ER Z
UNDERWRITING	AH N D ER R AY T IH NG
UNEMPLOYMENT	AH N IH M P L OY M AH N T
UNEXPECTED	AH N IH K S P EH K T IH D
UNFAIR	AH N F EH R
UNFAIR(2)	AO N F EH R
UNFORTUNATELY	AH N F AO R CH AH N AH T L IY
UNFORTUNATELY(2)	AH N F AO R CH UW N AH T L IY
UNION	Y UW N Y AH N
UNION'S	Y UW N Y AH N Z
UNIONS	Y UW N Y AH N Z
UNIQUE	Y UW N IY K
UNISYS	Y UW N IH S IH S
UNIT	Y UW N AH T
UNIT(2)	Y UW N IH T
UNIT'S	Y UW N IH T S
UNITED	Y UW N AY T AH D
UNITED(2)	Y UW N AY T IH D
UNITS	Y UW N AH T S
UNITS(2)	Y UW N IH T S
UNIVERSAL	Y UW N AH V ER S AH L
UNIVERSITIES	Y UW N AH V ER S AH T IY Z
UNIVERSITY	Y UW N AH V ER S AH T IY
UNLESS	AH N L EH S
UNLIKE	AH N L AY K
UNLIKELY	AH N L AY K L IY
UNPRECEDENTED	AH N P R EH S IH D EH N T IH D
UNREST	AH N R EH S T
UNSECURED	AH N S IH K Y UH R D
UNSECURED(2)	AH N S IY K Y UH R D
UNSOLICITED	AH N S AH L IH S IH T IH D
UNSPECIFIED	AH N S P EH S AH F AY D
UNSUCCESSFUL	AH N S AH K S EH S F AH L
UNTIL	AH N T IH L
UNUSUAL	AH N Y UW ZH AH W AH L
UNUSUAL(2)	AH N Y UW ZH UW AH L
UNUSUAL(3)	AH N Y UW ZH W AH L
UNUSUALLY	AH N Y UW ZH AH W AH L IY
UNUSUALLY(2)	AH N Y UW ZH UW AH L IY
UNUSUALLY(3)	AH N Y UW ZH W AH L IY
UNVEILED	AH N V EY L D
UP	AH P
UPHAM	AH P AH M
UPHELD	AH P HH EH L D
UPON	AH P AA N
UPPER	AH P ER
UPSET	AH P S EH T
UPWARD	AH P W ER D
URBAN	ER B AH N
URGED	ER JH D
URGING	ER JH IH NG
US	AH S
US(2)	Y UW EH S
USE	Y UW S
USE(2)	Y UW Z
USED	Y UW Z D
USEFUL	Y UW S F AH L
USERS	Y UW Z ER Z
USES	Y UW S AH Z
USES(2)	Y UW S IH Z
USES(3)	Y UW Z AH Z
USES(4)	Y UW Z IH Z
USING	Y UW Z IH NG
USUAL	Y UW ZH AH W AH L
USUAL(2)	Y UW ZH UW AH L
USUALLY	Y UW ZH AH L IY
USUALLY(2)	Y UW ZH AH W AH L IY
UTAH	Y UW T AO
UTILITIES	Y UW T IH L AH T IY Z
UTILITY	Y UW T IH L AH T IY
UTILITY'S	Y UW T IH L AH T IY Z
V.	V IY
VACATION	V EY K EY SH AH N
VALLEY	V AE L IY
VALUABLE	V AE L Y AH B AH L
VALUABLE(2)	V AE L Y UW B AH L
VALUE	V AE L Y UW
VALUED	V AE L Y UW D
VALUES	V AE L Y UW Z
VAN	V AE N
VARIETY	V ER AY AH T IY
VARIOUS	V EH R IY AH S
VARY	V EH R IY
VAST	V AE S T
VEGAS	V EY G AH S
VEHICLE	V IY HH IH K AH L
VEHICLE(2)	V IY IH K AH L
VEHICLES	V IY HH IH K AH L Z
VEHICLES(2)	V IY IH K AH L Z
VENTURE	V EH N CH ER
VENTURES	V EH N CH ER Z
VERDICT	V ER D IH K T
VERMONT	V ER M AA N T
VERSION	V ER ZH AH N
VERSIONS	V ER ZH AH N Z
VERSUS	V ER S AH S
VERSUS(2)	V ER S AH Z
VERY	V EH R IY
VETERAN	V EH T ER AH N
VETERAN(2)	V EH T R AH N
VETERANS	V EH T ER AH N Z
VETERANS(2)	V EH T R AH N Z
VETO	V IY T OW
VIA	V AY AH
VIA(2)	V IY AH
VICE	V AY S
VICTIM	V IH K T AH M
VICTIM(2)	V IH K T IH M
VICTIMS	V IH K T AH M Z
VICTIMS(2)	V IH K T IH M Z
VICTOR	V IH K T ER
VICTORY	V IH K T ER IY
VICTORY(2)	V IH K T R IY
VIDEO	V IH D IY OW
VIETNAM	V IY EH T N AA M
VIEW	V Y UW
VIEWED	V Y UW D
VIEWERS	V Y UW ER Z
VIEWS	V Y UW Z
VIGOROUSLY	V IH G ER AH S L IY
VILLAGE	V IH L AH JH
VILLAGE(2)	V IH L IH JH
VIOLATE	V AY AH L EY T
VIOLATED	V AY AH L EY T IH D
VIOLATING	V AY AH L EY T IH NG
VIOLATION	V AY AH L EY SH AH N
VIOLATIONS	V AY AH L EY SH AH N Z
VIOLENCE	V AY AH L AH N S
VIRGINIA	V ER JH IH N Y AH
VIRTUALLY	V ER CH UW AH L IY
VIRTUALLY(2)	V ER CH UW L IY
VIRUS	V AY R AH S
VISION	V IH ZH AH N
VISIT	V IH Z AH T
VISIT(2)	V IH Z IH T
VISITED	V IH Z AH T AH D
VISITED(2)	V IH Z IH T IH D
VITAL	V AY T AH L
VOICE	V OY S
VOLATILE	V AA L AH T AH L
VOLATILITY	V AA L AH T IH L AH T IY
VOLCKER	V OW L K ER
VOLKSWAGEN	V OW L K S W AE G AH N
VOLUME	V AA L Y UW M
VOLUNTARY	V AA L AH N T EH R IY
VOTE	V OW T
VOTED	V OW T AH D
VOTED(2)	V OW T IH D
VOTERS	V OW T ER Z
VOTES	V OW T S
VOTING	V OW T IH NG
VULNERABLE	V AH L N ER AH B AH L
W.	D AH B AH L Y UW
WAGE	W EY JH
WAGES	W EY JH AH Z
WAGES(2)	W EY JH IH Z
WAIT	W EY T
WAITING	W EY T IH NG
WAKE	W EY K
WALK	W AA K
WALK(2)	W AO K
WALKER	W AO K ER
WALL	W AO L
WALLS	W AO L Z
WALSH	W AO L SH
WALTER	W AO L T ER
WANG	W AE NG
WANT	W AA N T
WANT(2)	W AO N T
WANTED	W AA N T AH D
WANTED(2)	W AO N IH D
WANTED(3)	W AO N T IH D
WANTS	W AA N T S
WANTS(2)	W AO N T S
WAR	W AO R
WARD	W AO R D
WARNED	W AO R N D
WARNER	W AO R N ER
WARNING	W AO R N IH NG
WARNS	W AO R N Z
WARRANT	W AO R AH N T
WARRANTS	W AO R AH N T S
WARREN	W AO R AH N
WARS	W AO R Z
WAS	W AA Z
WAS(2)	W AH Z
WAS(3)	W AO Z
WASHINGTON	W AA SH IH NG T AH N
WASHINGTON(2)	W AO SH IH NG T AH N
WASN'T	W AA Z AH N T
WASN'T(2)	W AH Z AH N T
WASTE	W EY S T
WATCH	W AA CH
WATCH(2)	W AO CH
WATCHED	W AA CH T
WATCHED(2)	W AO CH T
WATCHING	W AA CH IH NG
WATER	W AO T ER
WATERS	W AO T ER Z
WAVE	W EY V
WAY	W EY
WAYNE	W EY N
WAYS	W EY Z
WE	W IY
WE'D	W IY D
WE'LL	W IH L
WE'LL(2)	W IY L
WE'RE	W ER
WE'RE(2)	W IH R
WE'RE(3)	W IY R
WE'VE	W IY V
WEAK	W IY K
WEAKENED	W IY K AH N D
WEAKER	W IY K ER
WEAKNESS	W IY K N AH S
WEALTH	W EH L TH
WEALTHY	W EH L TH IY
WEAPON	W EH P AH N
WEAPONS	W EH P AH N Z
WEAR	W EH R
WEARING	W EH R IH NG
WEATHER	W EH DH ER
WEDNESDAY	W EH N Z D EY
WEDNESDAY(2)	W EH N Z D IY
WEEK	W IY K
WEEK'S	W IY K S
WEEKEND	W IY K EH N D
WEEKEND(2)	W IY K IH N D
WEEKLY	W IY K L IY
WEEKS	W IY K S
WEIGHT	W EY T
WELCOME	W EH L K AH M
WELFARE	W EH L F EH R
WELL	W EH L
WELLS	W EH L Z
WENT	W EH N T
WERE	W ER
WEREN'T	W ER AH N T
WEREN'T(2)	W ER N T
WEST	W EH S T
WESTERN	HH W EH S T ER N
WESTERN(2)	W EH S T ER N
WESTINGHOUSE	W EH S T IH NG HH AW S
WHAT	HH W AH T
WHAT(2)	W AH T
WHAT'S	HH W AH T S
WHAT'S(2)	W AH T S
WHATEVER	HH W AH T EH V ER
WHATEVER(2)	W AH T EH V ER
WHEAT	HH W IY T
WHEAT(2)	W IY T
WHEN	HH W EH N
WHEN(2)	HH W IH N
WHEN(3)	W EH N
WHEN(4)	W IH N
WHERE	HH W EH R
WHERE(2)	W EH R
WHETHER	HH W EH DH ER
WHETHER(2)	W EH DH ER
WHICH	HH W IH CH
WHICH(2)	W IH CH
WHILE	HH W AY L
WHILE(2)	W AY L
WHITE	HH W AY T
WHITE(2)	W AY T
WHITES	HH W AY T S
WHITES(2)	W AY T S
WHO	HH UW
WHO'S	HH UW Z
WHOLE	HH OW L
WHOLESALE	HH OW L S EY L
WHOM	HH UW M
WHOSE	HH UW Z
WHY	HH W AY
WHY(2)	W AY
WICKES	W IH K S
WIDE	W AY D
WIDELY	W AY D L IY
WIDENED	W AY D AH N D
WIDER	W AY D ER
WIDESPREAD	W AY D S P R EH D
WIFE	W AY F
WILD	W AY L D
WILL	W AH L
WILL(2)	W IH L
WILLIAM	W IH L Y AH M
WILLIAMS	W IH L Y AH M Z
WILLING	W IH L IH NG
WILLINGNESS	W IH L IH NG N AH S
WILSON	W IH L S AH N
WIN	W IH N
WIND	W AY N D
WIND(2)	W IH N D
WINDOW	W IH N D OW
WINE	W AY N
WING	W IH NG
WINNER	W IH N ER
WINNING	W IH N IH NG
WINS	W IH N Z
WINTER	W IH N T ER
WIRE	W AY ER
WIRE(2)	W AY R
WISCONSIN	W IH S K AA N S AH N
WISH	W IH SH
WITH	W IH DH
WITH(2)	W IH TH
WITHDRAW	W IH DH D R AO
WITHDRAW(2)	W IH TH D R AO
WITHDRAWAL	W IH DH D R AO AH L
WITHDRAWAL(2)	W IH TH D R AO AH L
WITHDREW	W IH DH D R UW
WITHDREW(2)	W IH TH D R UW
WITHIN	W IH DH IH N
WITHIN(2)	W IH TH IH N
WITHOUT	W IH DH AW T
WITHOUT(2)	W IH TH AW T
WITNESSES	W IH T N AH S AH Z
WITNESSES(2)	W IH T N AH S IH Z
WITTER	W IH T ER
WOLF	W UH L F
WOMAN	W UH M AH N
WOMEN	W IH M AH N
WOMEN'S	W IH M AH N Z
WON	W AA N
WON(2)	W AH N
WON'T	W OW N T
WONDER	W AH N D ER
WOOD	W UH D
WORD	W ER D
WORDS	W ER D Z
WORK	W ER K
WORKED	W ER K T
WORKER	W ER K ER
WORKERS	W ER K ER Z
WORKING	W ER K IH NG
WORKS	W ER K S
WORLD	W ER L D
WORLD'S	W ER L D Z
WORRIED	W ER IY D
WORRIES	W ER IY Z
WORRY	W ER IY
WORSE	W ER S
WORST	W ER S T
WORTH	W ER TH
WOULD	W UH D
WOULDN'T	W UH D AH N T
WRIGHT	R AY T
WRITE	R AY T
WRITER	R AY T ER
WRITERS	R AY T ER Z
WRITES	R AY T S
WRITING	R AY T IH NG
WRITTEN	R IH T AH N
WRONG	R AO NG
WRONGDOING	R AO NG D UW IH NG
WROTE	R OW T
X.	AE K S
X.(2)	EH K S
XEROX	Z IH R AA K S
Y.	W AY
YEAR	Y IH R
YEAR'S	Y IH R Z
YEARS	Y ER Z
YEARS(2)	Y IH R Z
YELLOW	Y EH L OW
YEN	Y EH N
YES	Y EH S
YESTERDAY	Y EH S T ER D EY
YESTERDAY(2)	Y EH S T ER D IY
YESTERDAY'S	Y EH S T ER D EY Z
YESTERDAY'S(2)	Y EH S T ER D IY Z
YET	Y EH T
YIELD	Y IY L D
YIELDS	Y IY L D Z
YORK	Y AO R K
YORK'S	Y AO R K S
YOU	Y UW
YOU'LL	Y UW L
YOU'RE	Y UH R
YOU'RE(2)	Y UW R
YOU'VE	Y UW V
YOUNG	Y AH NG
YOUNGER	Y AH NG G ER
YOUR	Y AO R
YOUR(2)	Y UH R
YOUTH	Y UW TH
Z.	Z IY
ZEALAND	Z IY L AH N D
ZERO	Z IH R OW
ZERO(2)	Z IY R OW
ZURICH	Z UH R IH K
{LEFT-BRACE	L EH F T B R EY S
}RIGHT-BRACE	R AY T B R EY S
