'CAUSE	K AH Z
A	AH
A(2)	EY
A.	EY
ABILENE	AE B IH L IY N
ABILITIES	AH B IH L AH T IY Z
ABILITY	AH B IH L AH T IY
ABLE	EY B AH L
ABORTION	AH B AO R SH AH N
ABOUT	AH B AW T
ABOVE	AH B AH V
ABROAD	AH B R AO D
ABSENTEE	AE B S AH N T IY
ABSOLUTE	AE B S AH L UW T
ABSOLUTELY	AE B S AH L UW T L IY
ABUSE	AH B Y UW S
ABUSE(2)	AH B Y UW Z
ABUSED	AH B Y UW Z D
ACADEMIC	AE K AH D EH M IH K
ACADEMY	AH K AE D AH M IY
ACCENT	AH K S EH N T
ACCENT(2)	AE K S EH N T
ACCEPT	AE K S EH P T
ACCEPT(2)	AH K S EH P T
ACCEPTABLE	AE K S EH P T AH B AH L
ACCEPTABLE(2)	AH K S EH P T AH B AH L
ACCEPTED	AE K S EH P T IH D
ACCEPTED(2)	AH K S EH P T AH D
ACCESS	AE K S EH S
ACCIDENT	AE K S AH D AH N T
ACCIDENTS	AE K S AH D AH N T S
ACCOMPLISH	AH K AA M P L IH SH
ACCORD	AH K AO R D
ACCORDING	AH K AO R D IH NG
ACCOUNT	AH K AW N T
ACCOUNTANT	AH K AW N T AH N T
ACCOUNTING	AH K AW N T IH NG
ACCOUNTING(2)	AH K AW N IH NG
ACCOUNTS	AH K AW N T S
ACCURATE	AE K Y ER AH T
ACCUSED	AH K Y UW Z D
ACCUSTOMED	AH K AH S T AH M D
ACID	AE S AH D
ACOUSTICS	AH K UW S T IH K S
ACRE	EY K ER
ACRES	EY K ER Z
ACROSS	AH K R AO S
ACT	AE K T
ACTING	AE K T IH NG
ACTION	AE K SH AH N
ACTIONS	AE K SH AH N Z
ACTIVE	AE K T IH V
ACTIVITIES	AE K T IH V AH T IY Z
ACTIVITIES(2)	AE K T IH V IH T IY Z
ACTIVITY	AE K T IH V AH T IY
ACTIVITY(2)	AE K T IH V IH T IY
ACTOR	AE K T ER
ACTUAL	AE K CH AH W AH L
ACTUAL(2)	AE K SH AH L
ACTUALLY	AE K CH AH W AH L IY
ACTUALLY(2)	AE K SH L IY
ACTUALLY(3)	AE K CH L IY
ACTUALLY(4)	AE K SH AH L IY
AD	AE D
ADD	AE D
ADDED	AE D AH D
ADDED(2)	AE D IH D
ADDICTED	AH D IH K T AH D
ADDICTED(2)	AH D IH K T IH D
ADDING	AE D IH NG
ADDISON	AE D AH S AH N
ADDISON(2)	AE D IH S AH N
ADDITION	AH D IH SH AH N
ADDITIONAL	AH D IH SH AH N AH L
ADDITIONAL(2)	AH D IH SH N AH L
ADDRESS	AE D R EH S
ADDRESS(2)	AH D R EH S
ADDS	AE D Z
ADEQUATE	AE D AH K W AH T
ADEQUATE(2)	AE D AH K W EY T
ADJUST	AH JH AH S T
ADJUSTED	AH JH AH S T AH D
ADJUSTED(2)	AH JH AH S T IH D
ADMINISTRATION	AE D M IH N IH S T R EY SH AH N
ADMINISTRATIVE	AH D M IH N AH S T R EY T IH V
ADMINISTRATOR	AH D M IH N AH S T R EY T ER
ADMINISTRATORS	AE D M IH N IH S T R EY T ER Z
ADMIRE	AE D M AY R
ADMIT	AH D M IH T
ADMITTED	AH D M IH T AH D
ADOPT	AH D AA P T
ADOPTED	AH D AA P T AH D
ADS	AE D Z
ADULT	AH D AH L T
ADULT(2)	AE D AH L T
ADULTS	AH D AH L T S
ADULTS(2)	AE D AH L T S
ADVANCE	AH D V AE N S
ADVANCED	AH D V AE N S T
ADVANTAGE	AE D V AE N T IH JH
ADVANTAGE(2)	AH D V AE N T IH JH
ADVANTAGE(3)	AE D V AE N IH JH
ADVANTAGE(4)	AH D V AE N AH JH
ADVANTAGES	AE D V AE N T IH JH IH Z
ADVANTAGES(2)	AH D V AE N T IH JH IH Z
ADVANTAGES(3)	AE D V AE N IH JH IH Z
ADVANTAGES(4)	AH D V AE N IH JH IH Z
ADVENTURE	AE D V EH N CH ER
ADVENTURE(2)	AH D V EH N CH ER
ADVERTISE	AE D V ER T AY Z
ADVERTISED	AE D V ER T AY Z D
ADVERTISED(2)	AE D V ER T AY Z D
ADVERTISEMENTS	AE D V ER T AY Z M AH N T S
ADVERTISING	AE D V ER T AY Z IH NG
ADVICE	AE D V AY S
ADVICE(2)	AH D V AY S
ADVISE	AE D V AY Z
ADVISE(2)	AH D V AY Z
ADVOCATE	AE D V AH K AH T
ADVOCATE(2)	AE D V AH K EY T
AEROBIC	EH R OW B IH K
AEROBICS	ER OW B IH K S
AETNA	EH T N AH
AFFAIR	AH F EH R
AFFECT	AH F EH K T
AFFECTED	AH F EH K T AH D
AFFECTED(2)	AH F EH K T IH D
AFFECTS	AH F EH K T S
AFFORD	AH F AO R D
AFRAID	AH F R EY D
AFRICA	AE F R AH K AH
AFRICA(2)	AE F R IH K AH
AFRICA(3)	AE F ER K AH
AFTER	AE F T ER
AFTERNOON	AE F T ER N UW N
AFTERNOONS	AE F T ER N UW N Z
AFTERWARDS	AE F T ER W ER D Z
AGAIN	AH G EH N
AGAIN(2)	AH G EY N
AGAINST	AH G EH N S T
AGE	EY JH
AGENCIES	EY JH AH N S IY Z
AGENCY	EY JH AH N S IY
AGENT	EY JH AH N T
AGES	EY JH AH Z
AGES(2)	EY JH IH Z
AGGRESSIVE	AH G R EH S IH V
AGO	AH G OW
AGREE	AH G R IY
AGREED	AH G R IY D
AGREEMENT	AH G R IY M AH N T
AHEAD	AH HH EH D
AID	EY D
AIDS	EY D Z
AIKMAN	EY K M AH N
AIN'T	EY N T
AIR	EH R
AIRLINE	EH R L AY N
AIRLINES	EH R L AY N Z
AIRPLANE	EH R P L EY N
AIRPLANES	EH R P L EY N Z
AIRPORT	EH R P AO R T
ALABAMA	AE L AH B AE M AH
ALARM	AH L AA R M
ALASKA	AH L AE S K AH
ALBUM	AE L B AH M
ALBUMS	AE L B AH M Z
ALCOHOL	AE L K AH HH AA L
ALCOHOLIC	AE L K AH HH AA L IH K
ALIKE	AH L AY K
ALIVE	AH L AY V
ALL	AO L
ALLERGIC	AH L ER JH IH K
ALLEY	AE L IY
ALLOW	AH L AW
ALLOWED	AH L AW D
ALLOWING	AH L AW IH NG
ALLOWS	AH L AW Z
ALMOST	AO L M OW S T
ALONE	AH L OW N
ALONG	AH L AO NG
ALREADY	AO L R EH D IY
ALREADY(2)	AO R EH D IY
ALRIGHT	AO L R AY T
ALSO	AO L S OW
ALTERNATE	AO L T ER N AH T
ALTERNATE(2)	AO L T ER N EY T
ALTERNATIVE	AO L T ER N AH T IH V
ALTHOUGH	AO L DH OW
ALTOGETHER	AO L T AH G EH DH ER
ALUMINUM	AH L UW M AH N AH M
ALWAYS	AO L W EY Z
ALWAYS(2)	AO L W IY Z
ALZHEIMER'S	AE L Z HH AY M ER Z
ALZHEIMER'S(2)	AA T S Z HH AY M ER Z
AM	AE M
AM(2)	EY EH M
AMARILLO	AE M ER IH L OW
AMAZED	AH M EY Z D
AMAZES	AH M EY Z IH Z
AMAZING	AH M EY Z IH NG
AMERICA	AH M EH R AH K AH
AMERICA(2)	AH M EH R IH K AH
AMERICA'S	AH M EH R AH K AH Z
AMERICA'S(2)	AH M EH R IH K AH Z
AMERICAN	AH M EH R AH K AH N
AMERICAN(2)	AH M EH R IH K AH N
AMERICANS	AH M EH R AH K AH N Z
AMERICANS(2)	AH M EH R IH K AH N Z
AMIGA	AH M IY G AH
AMONG	AH M AH NG
AMOUNT	AH M AW N T
AMOUNTS	AH M AW N T S
AN	AE N
AN(2)	AH N
ANALYSIS	AH N AE L AH S AH S
ANALYSIS(2)	AH N AE L IH S IH S
AND	AE N D
AND(2)	AH N D
ANGELES	AE N JH AH L IH S
ANGLE	AE NG G AH L
ANGRY	AE NG G R IY
ANIMAL	AE N AH M AH L
ANIMALS	AE N AH M AH L Z
ANKLE	AE NG K AH L
ANN	AE N
ANNIVERSARY	AE N AH V ER S ER IY
ANNOUNCED	AH N AW N S T
ANNOYING	AH N OY IH NG
ANNUAL	AE N Y UW AH L
ANOTHER	AH N AH DH ER
ANSWER	AE N S ER
ANSWERING	AE N S ER IH NG
ANSWERS	AE N S ER Z
ANTI	AE N T IY
ANTI(2)	AE N T AY
ANTONIO	AE N T OW N IY OW
ANXIOUS	AE NG K SH AH S
ANXIOUS(2)	AE NG SH AH S
ANY	EH N IY
ANYBODY	EH N IY B AH D IY
ANYBODY'S	EH N IY B AH D IY Z
ANYHOW	EH N IY HH AW
ANYMORE	EH N IY M AO R
ANYONE	EH N IY W AH N
ANYONE(2)	EH N IY W AH N
ANYTHING	EH N IY TH IH NG
ANYTIME	EH N IY T AY M
ANYWAY	EH N IY W EY
ANYWAYS	EH N IY W EY Z
ANYWHERE	EH N IY W EH R
ANYWHERE(2)	EH N IY HH W EH R
APART	AH P AA R T
APARTMENT	AH P AA R T M AH N T
APARTMENTS	AH P AA R T M AH N T S
APPARENTLY	AH P EH R AH N T L IY
APPEAL	AH P IY L
APPEALING	AH P IY L IH NG
APPEALS	AH P IY L Z
APPEAR	AH P IH R
APPEARANCE	AH P IH R AH N S
APPEARS	AH P IH R Z
APPLE	AE P AH L
APPLES	AE P AH L Z
APPLICATION	AE P L AH K EY SH AH N
APPLICATIONS	AE P L AH K EY SH AH N Z
APPLIED	AH P L AY D
APPLY	AH P L AY
APPLYING	AH P L AY IH NG
APPOINTMENT	AH P OY N T M AH N T
APPRECIATE	AH P R IY SH IY EY T
APPROACH	AH P R OW CH
APPROPRIATE	AH P R OW P R IY AH T
APPROPRIATE(2)	AH P R OW P R IY EY T
APPROVE	AH P R UW V
APPROVED	AH P R UW V D
APRIL	EY P R AH L
ARAB	AE R AH B
ARAB(2)	EH R AH B
ARABIA	ER EY B IY AH
ARABS	AE R AH B Z
ARABS(2)	EH R AH B Z
ARE	AA R
ARE(2)	ER
AREA	EH R IY AH
AREAS	EH R IY AH Z
AREN'T	AA R AH N T
AREN'T(2)	AA R N T
ARGENTINA	AA R JH AH N T IY N AH
ARGUE	AA R G Y UW
ARGUING	AA R G Y UW IH NG
ARGUMENT	AA R G Y AH M AH N T
ARGUMENTS	AA R G Y AH M AH N T S
ARIZONA	EH R IH Z OW N AH
ARKANSAS	AA R K AH N S AA
ARLINGTON	AA R L IH NG T AH N
ARM	AA R M
ARMED	AA R M D
ARMS	AA R M Z
ARMY	AA R M IY
AROUND	ER AW N D
AROUND(2)	ER AW N
ARRANGEMENT	ER EY N JH M AH N T
ARRANGEMENTS	ER EY N JH M AH N T S
ARRESTED	ER EH S T AH D
ARRESTED(2)	ER EH S T IH D
ART	AA R T
ARTHRITIS	AA R TH R AY T AH S
ARTHRITIS(2)	AA R TH R AY T IH S
ARTICLE	AA R T AH K AH L
ARTICLE(2)	AA R T IH K AH L
ARTICLES	AA R T AH K AH L Z
ARTICLES(2)	AA R T IH K AH L Z
ARTIST	AA R T AH S T
ARTIST(2)	AA R T IH S T
ARTS	AA R T S
AS	AE Z
AS(2)	EH Z
ASIAN	EY ZH AH N
ASIDE	AH S AY D
ASK	AE S K
ASKED	AE S K T
ASKED(2)	AO S K T
ASKING	AE S K IH NG
ASLEEP	AH S L IY P
ASPECT	AE S P EH K T
ASPECTS	AE S P EH K T S
ASSAULT	AH S AO L T
ASSISTANCE	AH S IH S T AH N S
ASSISTANT	AH S IH S T AH N T
ASSOCIATE	AH S OW S IY AH T
ASSOCIATE(2)	AH S OW S IY EY T
ASSOCIATE(3)	AH S OW SH IY AH T
ASSOCIATE(4)	AH S OW SH IY EY T
ASSOCIATED	AH S OW S IY EY T AH D
ASSOCIATED(2)	AH S OW SH IY EY T AH D
ASSOCIATION	AH S OW S IY EY SH AH N
ASSOCIATION(2)	AH S OW SH IY EY SH AH N
ASSUME	AH S UW M
ASSUMED	AH S UW M D
AT	AE T
ATE	EY T
ATHLETE	AE TH L IY T
ATHLETES	AE TH L IY T S
ATHLETIC	AE TH L EH T IH K
ATHLETICS	AE TH L EH T IH K S
ATLANTA	AE T L AE N T AH
ATLANTA(2)	AH T L AE N T AH
ATLANTA(3)	AE T L AE N AH
ATLANTA(4)	AH T L AE N AH
ATMOSPHERE	AE T M AH S F IH R
ATTACHED	AH T AE CH T
ATTACK	AH T AE K
ATTACKS	AH T AE K S
ATTEMPT	AH T EH M P T
ATTEND	AH T EH N D
ATTENTION	AH T EH N SH AH N
ATTITUDE	AE T AH T UW D
ATTITUDES	AE T AH T UW D Z
ATTLEBORO	AE T AH L B ER OW
ATTORNEY	AH T ER N IY
ATTORNEYS	AH T ER N IY Z
ATTRACT	AH T R AE K T
ATTRACTION	AH T R AE K SH AH N
ATTRACTIVE	AH T R AE K T IH V
AUDIENCE	AA D IY AH N S
AUDIENCE(2)	AO D IY AH N S
AUGUST	AA G AH S T
AUGUST(2)	AO G AH S T
AUGUSTINE	AA G AH S T IY N
AUGUSTINE(2)	AO G AH S T IY N
AUNT	AE N T
AUNT(2)	AO N T
AUNTS	AE N T S
AUNTS(2)	AO N T S
AUSTIN	AO S T AH N
AUSTRALIA	AO S T R EY L Y AH
AUTHOR	AO TH ER
AUTHORITY	AH TH AO R AH T IY
AUTO	AO T OW
AUTOMATIC	AO T AH M AE T IH K
AUTOMATIC(2)	AO T OW M AE T IH K
AUTOMATICALLY	AO T AH M AE T IH K L IY
AUTOMATICALLY(2)	AO T OW M AE T IH K L IY
AUTOMOBILE	AO T AH M OW B IY L
AUTOMOBILE(2)	AO T AH M OW B IY L
AUTOMOBILES	AO T AH M OW B IY L Z
AUTOMOBILES(2)	AO T AH M OW B IY L Z
AVAILABLE	AH V EY L AH B AH L
AVERAGE	AE V ER IH JH
AVERAGE(2)	AE V R AH JH
AVERAGE(3)	AE V R IH JH
AVID	AE V AH D
AVID(2)	AE V IH D
AVOID	AH V OY D
AWAKENING	AH W EY K AH N IH NG
AWARD	AH W AO R D
AWARDS	AH W AO R D Z
AWARE	AH W EH R
AWARENESS	AH W EH R N AH S
AWAY	AH W EY
AWFUL	AA F AH L
AWFUL(2)	AO F AH L
AWFULLY	AA F L IY
AWFULLY(2)	AO F AH L IY
AWHILE	AH W AY L
B.	B IY
BABIES	B EY B IY Z
BABY	B EY B IY
BACK	B AE K
BACKED	B AE K T
BACKGROUND	B AE K G R AW N D
BACKING	B AE K IH NG
BACKPACK	B AE K P AE K
BACKPACKING	B AE K P AE K AH NG
BACKS	B AE K S
BACKWARDS	B AE K W ER D Z
BACKYARD	B AE K Y AA R D
BAD	B AE D
BADLY	B AE D L IY
BAG	B AE G
BAGS	B AE G Z
BAIT	B EY T
BAKE	B EY K
BAKED	B EY K T
BAKING	B EY K IH NG
BALANCE	B AE L AH N S
BALANCED	B AE L AH N S T
BALL	B AO L
BALLS	B AO L Z
BALTIMORE	B AO L T AH M AO R
BAN	B AE N
BAND	B AE N D
BANDS	B AE N D Z
BANG	B AE NG
BANK	B AE NG K
BANKING	B AE NG K IH NG
BANKRUPT	B AE NG K R AH P T
BANKS	B AE NG K S
BAR	B AA R
BARBECUE	B AA R B IH K Y UW
BARELY	B EH R L IY
BARGAIN	B AA R G AH N
BARGAIN(2)	B AA R G IH N
BARK	B AA R K
BARREL	B AE R AH L
BARREL(2)	B EH R AH L
BARS	B AA R Z
BASE	B EY S
BASEBALL	B EY S B AO L
BASED	B EY S T
BASEMENT	B EY S M AH N T
BASEMENTS	B EY S M AH N T S
BASES	B EY S AH Z
BASES(2)	B EY S IH Z
BASES(3)	B EY S IY Z
BASIC	B EY S IH K
BASICALLY	B EY S IH K L IY
BASICS	B EY S IH K S
BASIS	B EY S AH S
BASIS(2)	B EY S IH S
BASKET	B AE S K AH T
BASKETBALL	B AE S K AH T B AO L
BASS	B AE S
BASS(2)	B EY S
BAT	B AE T
BATH	B AE TH
BATHROOM	B AE TH R UW M
BATHROOMS	B AE TH R UW M Z
BATHROOMS(2)	B AA TH R UW M Z
BATTERIES	B AE T ER IY Z
BATTERY	B AE T ER IY
BATTLE	B AE T AH L
BAY	B EY
BE	B IY
BE(2)	B IY
BEACH	B IY CH
BEACHES	B IY CH AH Z
BEACHES(2)	B IY CH IH Z
BEAM	B IY M
BEAN	B IY N
BEANS	B IY N Z
BEAR	B EH R
BEARING	B EH R IH NG
BEARS	B EH R Z
BEAT	B IY T
BEATEN	B IY T AH N
BEATING	B IY T IH NG
BEATLES	B IY T AH L Z
BEAUTIFUL	B Y UW T AH F AH L
BEAUTY	B Y UW T IY
BECAME	B IH K EY M
BECAME(2)	B IY K EY M
BECAUSE	B IH K AO Z
BECAUSE(2)	B IH K AH Z
BECOME	B IH K AH M
BECOMES	B IH K AH M Z
BECOMING	B IH K AH M IH NG
BED	B EH D
BEDROOM	B EH D R UW M
BEDROOMS	B EH D R UW M Z
BEDS	B EH D Z
BEEF	B IY F
BEEN	B IH N
BEEN(2)	B AH N
BEEN(3)	B IH N
BEER	B IH R
BEFORE	B IH F AO R
BEFORE(2)	B IY F AO R
BEG	B EH G
BEGAN	B IH G AE N
BEGAN(2)	B IY G AE N
BEGIN	B IH G IH N
BEGINNING	B IH G IH N IH NG
BEHAVIOR	B IH HH EY V Y ER
BEHIND	B IH HH AY N D
BEING	B IY IH NG
BELIEFS	B IH L IY F S
BELIEVE	B IH L IY V
BELIEVED	B IH L IY V D
BELL	B EH L
BELONG	B IH L AO NG
BELOW	B IH L OW
BELOW(2)	B IY L OW
BELT	B EH L T
BELTS	B EH L T S
BENCH	B EH N CH
BEND	B EH N D
BENEFICIAL	B EH N AH F IH SH AH L
BENEFIT	B EH N AH F IH T
BENEFITS	B EH N AH F IH T S
BERKELEY	B ER K L IY
BERMUDA	B ER M Y UW D AH
BESIDES	B IH S AY D Z
BEST	B EH S T
BET	B EH T
BETTER	B EH T ER
BETWEEN	B IH T W IY N
BETWEEN(2)	B IY T W IY N
BEYOND	B IH AA N D
BEYOND(2)	B IY AO N D
BEYOND(3)	B IH AO N D
BIAS	B AY AH S
BIASED	B AY AH S T
BIBLE	B AY B AH L
BICYCLE	B AY S IH K AH L
BIG	B IH G
BIGGER	B IH G ER
BIGGEST	B IH G AH S T
BIKE	B AY K
BIKES	B AY K S
BIKING	B AY K IH NG
BILL	B IH L
BILLION	B IH L Y AH N
BILLIONS	B IH L Y AH N Z
BILLS	B IH L Z
BILLY	B IH L IY
BIN	B IH N
BINS	B IH N Z
BIRD	B ER D
BIRDS	B ER D Z
BIRTH	B ER TH
BIRTHDAY	B ER TH D EY
BIT	B IH T
BITE	B AY T
BITS	B IH T S
BITTY	B IH T IY
BIZARRE	B AH Z AA R
BIZARRE(2)	B IH Z AA R
BLACK	B L AE K
BLACKS	B L AE K S
BLADE	B L EY D
BLAH	B L AA
BLAME	B L EY M
BLANK	B L AE NG K
BLESS	B L EH S
BLEW	B L UW
BLOCK	B L AA K
BLOCKS	B L AA K S
BLOOD	B L AH D
BLOOM	B L UW M
BLOOMING	B L UW M IH NG
BLOW	B L OW
BLOWING	B L OW IH NG
BLOWN	B L OW N
BLOWS	B L OW Z
BLUE	B L UW
BLUES	B L UW Z
BOARD	B AO R D
BOARDS	B AO R D Z
BOAT	B OW T
BOATING	B OW T IH NG
BOATS	B OW T S
BOB	B AA B
BODY	B AA D IY
BOLTS	B OW L T S
BOND	B AA N D
BONDS	B AA N D Z
BONUS	B OW N AH S
BOOK	B UH K
BOOKS	B UH K S
BOOM	B UW M
BOOTS	B UW T S
BORDER	B AO R D ER
BORDERS	B AO R D ER Z
BORED	B AO R D
BORING	B AO R IH NG
BORN	B AO R N
BORROW	B AA R OW
BORROWED	B AA R OW D
BORROWING	B AA R OW IH NG
BOSS	B AA S
BOSS(2)	B AO S
BOSTON	B AA S T AH N
BOSTON(2)	B AO S T AH N
BOTH	B OW TH
BOTHER	B AA DH ER
BOTHERED	B AA DH ER D
BOTHERS	B AA DH ER Z
BOTTLE	B AA T AH L
BOTTLES	B AA T AH L Z
BOTTOM	B AA T AH M
BOUGHT	B AA T
BOUGHT(2)	B AO T
BOUND	B AW N D
BOWL	B OW L
BOX	B AA K S
BOXES	B AA K S AH Z
BOXES(2)	B AA K S IH Z
BOY	B OY
BOYFRIEND	B OY F R EH N D
BOYS	B OY Z
BRACKET	B R AE K IH T
BRAIN	B R EY N
BRAKE	B R EY K
BRAKES	B R EY K S
BRANCH	B R AE N CH
BRAND	B R AE N D
BRAZIL	B R AH Z IH L
BREAD	B R EH D
BREAK	B R EY K
BREAKFAST	B R EH K F AH S T
BREAKING	B R EY K IH NG
BREAKS	B R EY K S
BRED	B R EH D
BREED	B R IY D
BRIAN	B R AY AH N
BRICK	B R IH K
BRICKS	B R IH K S
BRIDGE	B R IH JH
BRIDGES	B R IH JH AH Z
BRIDGES(2)	B R IH JH IH Z
BRIEF	B R IY F
BRIGHAM	B R IH G AH M
BRIGHT	B R AY T
BRING	B R IH NG
BRINGING	B R IH NG IH NG
BRINGS	B R IH NG Z
BRITISH	B R IH T IH SH
BROAD	B R AO D
BROADCAST	B R AO D K AE S T
BROCCOLI	B R AA K AH L IY
BROCCOLI(2)	B R AA K L IY
BROKE	B R OW K
BROKEN	B R OW K AH N
BROOKS	B R UH K S
BROTHER	B R AH DH ER
BROTHER'S	B R AH DH ER Z
BROTHERS	B R AH DH ER Z
BROUGHT	B R AO T
BROWN	B R AW N
BRUCE	B R UW S
BRUSH	B R AH SH
BUCK	B AH K
BUCKET	B AH K AH T
BUCKET(2)	B AH K IH T
BUCKS	B AH K S
BUDDY	B AH D IY
BUDGET	B AH JH IH T
BUDGETING	B AH JH IH T IH NG
BUDGETS	B AH JH IH T S
BUFF	B AH F
BUFFALO	B AH F AH L OW
BUG	B AH G
BUGS	B AH G Z
BUICK	B Y UW IH K
BUILD	B IH L D
BUILDER	B IH L D ER
BUILDING	B IH L D IH NG
BUILDINGS	B IH L D IH NG Z
BUILDS	B IH L D Z
BUILT	B IH L T
BULBS	B AH L B Z
BULK	B AH L K
BULLET	B UH L AH T
BUMPER	B AH M P ER
BUNCH	B AH N CH
BURDEN	B ER D AH N
BUREAUCRACY	B Y UH R AA K R AH S IY
BURN	B ER N
BURNED	B ER N D
BURNING	B ER N IH NG
BURNS	B ER N Z
BUS	B AH S
BUSES	B AH S IH Z
BUSH	B UH SH
BUSHES	B UH SH AH Z
BUSINESS	B IH Z N AH S
BUSINESS(2)	B IH Z N IH S
BUSINESSES	B IH Z N AH S AH Z
BUSINESSES(2)	B IH Z N IH S IH Z
BUSY	B IH Z IY
BUT	B AH T
BUTTER	B AH T ER
BUTTON	B AH T AH N
BUTTONS	B AH T AH N Z
BUY	B AY
BUYING	B AY IH NG
BUYS	B AY Z
BY	B AY
BYE	B AY
C.	S IY
CAB	K AE B
CABIN	K AE B AH N
CABINET	K AE B AH N AH T
CABINET(2)	K AE B N AH T
CABINETS	K AE B AH N AH T S
CABINETS(2)	K AE B N AH T S
CABINS	K AE B AH N Z
CABLE	K EY B AH L
CADILLAC	K AE D AH L AE K
CAFE	K AH F EY
CAFE(2)	K AE F EY
CAFETERIA	K AE F AH T IH R IY AH
CAGE	K EY JH
CAJUN	K EY JH AH N
CAKE	K EY K
CALIFORNIA	K AE L AH F AO R N Y AH
CALL	K AO L
CALLED	K AO L D
CALLING	K AO L IH NG
CALLS	K AO L Z
CALM	K AA M
CALM(2)	K AA L M
CAME	K EY M
CAMERA	K AE M ER AH
CAMERA(2)	K AE M R AH
CAMP	K AE M P
CAMPAIGN	K AE M P EY N
CAMPAIGNS	K AE M P EY N Z
CAMPBELL	K AE M B AH L
CAMPED	K AE M P T
CAMPER	K AE M P ER
CAMPING	K AE M P IH NG
CAMPS	K AE M P S
CAMPUS	K AE M P AH S
CAN	K AE N
CAN(2)	K AH N
CAN'T	K AE N T
CANADA	K AE N AH D AH
CANAL	K AH N AE L
CANCEL	K AE N S AH L
CANCER	K AE N S ER
CANDIDATE	K AE N D AH D EY T
CANDIDATE(2)	K AE N AH D IH T
CANDIDATES	K AE N D AH D EY T S
CANDIDATES(2)	K AE N AH D IH T S
CANDY	K AE N D IY
CANNED	K AE N D
CANNOT	K AE N AA T
CANNOT(2)	K AH N AA T
CANOEING	K AH N UW IH NG
CANS	K AE N Z
CANYON	K AE N Y AH N
CAPABLE	K EY P AH B AH L
CAPACITY	K AH P AE S AH T IY
CAPACITY(2)	K AH P AE S IH T IY
CAPE	K EY P
CAPITAL	K AE P AH T AH L
CAPITAL(2)	K AE P IH T AH L
CAR	K AA R
CARD	K AA R D
CARDBOARD	K AA R D B AO R D
CARDS	K AA R D Z
CARE	K EH R
CARED	K EH R D
CAREER	K ER IH R
CAREERS	K ER IH R Z
CAREFUL	K EH R F AH L
CAREFULLY	K EH R F AH L IY
CARES	K EH R Z
CARIBBEAN	K ER IH B IY AH N
CARING	K EH R IH NG
CAROLINA	K EH R AH L AY N AH
CARPET	K AA R P AH T
CARPETING	K AA R P AH T IH NG
CARRIED	K AE R IY D
CARRIED(2)	K EH R IY D
CARRY	K AE R IY
CARRY(2)	K EH R IY
CARRYING	K AE R IY IH NG
CARRYING(2)	K EH R IY IH NG
CARS	K AA R Z
CARS(2)	K AA Z
CART	K AA R T
CARTER	K AA R T ER
CARTONS	K AA R T AH N Z
CARTOON	K AA R T UW N
CARTOONS	K AA R T UW N Z
CASE	K EY S
CASES	K EY S AH Z
CASES(2)	K EY S IH Z
CASH	K AE SH
CASSETTE	K AH S EH T
CAST	K AE S T
CASUAL	K AE ZH AH W AH L
CASUAL(2)	K AE ZH W AH L
CAT	K AE T
CATALOGS	K AE T AH L AA G Z
CATALOGS(2)	K AE T AH L AO G Z
CATCH	K AE CH
CATCHING	K AE CH IH NG
CATEGORIES	K AE T AH G AO R IY Z
CATEGORY	K AE T AH G AO R IY
CATFISH	K AE T F IH SH
CATHOLIC	K AE TH L IH K
CATS	K AE T S
CAUGHT	K AA T
CAUGHT(2)	K AO T
CAUSE	K AA Z
CAUSE(2)	K AO Z
CAUSED	K AA Z D
CAUSED(2)	K AO Z D
CAUSES	K AA Z AH Z
CAUSES(2)	K AO Z IH Z
CAUSING	K AA Z IH NG
CAUSING(2)	K AO Z IH NG
CEDAR	S IY D ER
CEILING	S IY L IH NG
CEILINGS	S IY L IH NG Z
CELERY	S EH L ER IY
CELTICS	S EH L T IH K S
CENT	S EH N T
CENTER	S EH N T ER
CENTER(2)	S EH N ER
CENTERED	S EH N T ER D
CENTERS	S EH N T ER Z
CENTERS(2)	S EH N ER Z
CENTRAL	S EH N T R AH L
CENTS	S EH N T S
CENTS(2)	S EH N S
CENTURY	S EH N CH ER IY
CERTAIN	S ER T AH N
CERTAINLY	S ER T AH N L IY
CETERA	S EH T ER AH
CHAIN	CH EY N
CHAIR	CH EH R
CHAIRS	CH EH R Z
CHALLENGE	CH AE L AH N JH
CHALLENGING	CH AE L AH N JH IH NG
CHAMBER	CH EY M B ER
CHAMPIONSHIP	CH AE M P IY AH N SH IH P
CHANCE	CH AE N S
CHANCES	CH AE N S AH Z
CHANCES(2)	CH AE N S IH Z
CHANGE	CH EY N JH
CHANGED	CH EY N JH D
CHANGES	CH EY N JH AH Z
CHANGES(2)	CH EY N JH IH Z
CHANGING	CH EY N JH IH NG
CHANNEL	CH AE N AH L
CHANNELS	CH AE N AH L Z
CHARACTER	K EH R IH K T ER
CHARACTERS	K AE R IH K T ER Z
CHARACTERS(2)	K EH R AH K T ER Z
CHARGE	CH AA R JH
CHARGED	CH AA R JH D
CHARGES	CH AA R JH AH Z
CHARGES(2)	CH AA R JH IH Z
CHARGING	CH AA R JH IH NG
CHARLES	CH AA R L Z
CHARLES(2)	CH AA R AH L Z
CHARLOTTE	SH AA R L AH T
CHASE	CH EY S
CHASING	CH EY S IH NG
CHEAP	CH IY P
CHEAPER	CH IY P ER
CHEAPEST	CH IY P AH S T
CHECK	CH EH K
CHECKBOOK	CH EH K B UH K
CHECKED	CH EH K T
CHECKING	CH EH K IH NG
CHECKS	CH EH K S
CHEERS	CH IH R Z
CHEESE	CH IY Z
CHEMICAL	K EH M AH K AH L
CHEMICAL(2)	K EH M IH K AH L
CHEMICALS	K EH M IH K AH L Z
CHEMISTRY	K EH M AH S T R IY
CHEMISTRY(2)	K EH M IH S T R IY
CHEVROLET	SH EH V R AH L EY
CHEVROLET(2)	SH EH V R OW L EY
CHEVY	CH EH V IY
CHEVY(2)	SH EH V IY
CHICAGO	SH AH K AA G OW
CHICKEN	CH IH K AH N
CHIEF	CH IY F
CHILD	CH AY L D
CHILD'S	CH AY L D Z
CHILDHOOD	CH AY L D HH UH D
CHILDREN	CH IH L D R AH N
CHILDREN'S	CH IH L D R AH N Z
CHILI	CH IH L IY
CHINA	CH AY N AH
CHINESE	CH AY N IY Z
CHIP	CH IH P
CHIPS	CH IH P S
CHOCOLATE	CH AO K L AH T
CHOICE	CH OY S
CHOICES	CH OY S AH Z
CHOICES(2)	CH OY S IH Z
CHOIR	K W AY ER
CHOLESTEROL	K AH L EH S T ER AO L
CHOLESTEROL(2)	K AH L EH S T ER AH L
CHOOSE	CH UW Z
CHOOSING	CH UW Z IH NG
CHOP	CH AA P
CHORE	CH AO R
CHORES	CH AO R Z
CHOSE	CH OW Z
CHOSEN	CH OW Z AH N
CHRIST	K R AY S T
CHRISTIAN	K R IH S CH AH N
CHRISTIAN(2)	K R IH S CH IH N
CHRISTMAS	K R IH S M AH S
CHRYSLER	K R AY S L ER
CHUNK	CH AH NG K
CHURCH	CH ER CH
CHURCHES	CH ER CH AH Z
CHURCHES(2)	CH ER CH IH Z
CIGARETTES	S IH G ER EH T S
CIRCLE	S ER K AH L
CIRCUIT	S ER K AH T
CIRCUMSTANCES	S ER K AH M S T AE N S AH Z
CIRCUMSTANCES(2)	S ER K AH M S T AE N S IH Z
CITIES	S IH T IY Z
CITIZEN	S IH T AH Z AH N
CITIZEN(2)	S IH T IH Z AH N
CITIZENS	S IH T AH Z AH N Z
CITIZENS(2)	S IH T IH Z AH N Z
CITY	S IH T IY
CIVIC	S IH V IH K
CIVIL	S IH V AH L
CIVILIAN	S AH V IH L Y AH N
CIVILIZED	S IH V AH L AY Z D
CLAIM	K L EY M
CLARINET	K L EH R AH N EH T
CLARION	K L EH R IY AH N
CLASS	K L AE S
CLASSES	K L AE S AH Z
CLASSES(2)	K L AE S IH Z
CLASSIC	K L AE S IH K
CLASSICAL	K L AE S IH K AH L
CLASSICS	K L AE S IH K S
CLASSROOM	K L AE S R UW M
CLEAN	K L IY N
CLEANED	K L IY N D
CLEANER	K L IY N ER
CLEANING	K L IY N IH NG
CLEAR	K L IH R
CLEARLY	K L IH R L IY
CLEVELAND	K L IY V L AH N D
CLIENTS	K L AY AH N T S
CLIFF	K L IH F
CLIMATE	K L AY M AH T
CLIMATE(2)	K L AY M IH T
CLIMB	K L AY M
CLIP	K L IH P
CLIPPINGS	K L IH P IH NG Z
CLOCK	K L AA K
CLOSE	K L OW S
CLOSE(2)	K L OW Z
CLOSED	K L OW Z D
CLOSELY	K L OW S L IY
CLOSER	K L OW S ER
CLOSER(2)	K L OW Z ER
CLOSEST	K L OW S AH S T
CLOSET	K L AA Z AH T
CLOSING	K L OW Z IH NG
CLOTH	K L AO TH
CLOTHES	K L OW DH Z
CLOTHES(2)	K L OW Z
CLOTHING	K L OW DH IH NG
CLOUDS	K L AW D Z
CLUB	K L AH B
CLUBS	K L AH B Z
CLUE	K L UW
CLUTCH	K L AH CH
CO	K OW
COACH	K OW CH
COACHING	K OW CH IH NG
COAL	K OW L
COAST	K OW S T
COAT	K OW T
COATS	K OW T S
COCAINE	K OW K EY N
CODE	K OW D
CODES	K OW D Z
COFFEE	K AA F IY
COFFEE(2)	K AO F IY
COIN	K OY N
COKE	K OW K
COLD	K OW L D
COLDER	K OW L D ER
COLLAR	K AA L ER
COLLECT	K AH L EH K T
COLLECTED	K AH L EH K T AH D
COLLECTING	K AH L EH K T IH NG
COLLECTION	K AH L EH K SH AH N
COLLEGE	K AA L IH JH
COLLEGES	K AA L IH JH IH Z
COLOR	K AH L ER
COLOR(2)	K AO L ER
COLORADO	K AA L ER AA D OW
COLORADO(2)	K AA L ER AE D OW
COLORED	K AH L ER D
COLORS	K AH L ER Z
COMBAT	K AA M B AE T
COMBAT(2)	K AH M B AE T
COMBINATION	K AA M B AH N EY SH AH N
COME	K AH M
COMEDIES	K AA M AH D IY Z
COMEDY	K AA M AH D IY
COMES	K AH M Z
COMFORT	K AH M F ER T
COMFORTABLE	K AH M F ER T AH B AH L
COMING	K AH M IH NG
COMMAND	K AH M AE N D
COMMENT	K AA M EH N T
COMMENTS	K AA M EH N T S
COMMERCIAL	K AH M ER SH AH L
COMMERCIALS	K AH M ER SH AH L Z
COMMISSION	K AH M IH SH AH N
COMMIT	K AH M IH T
COMMITMENT	K AH M IH T M AH N T
COMMITS	K AH M IH T S
COMMITTED	K AH M IH T AH D
COMMITTEE	K AH M IH T IY
COMMITTING	K AH M IH T IH NG
COMMON	K AA M AH N
COMMUNICATE	K AH M Y UW N AH K EY T
COMMUNICATION	K AH M Y UW N AH K EY SH AH N
COMMUNICATIONS	K AH M Y UW N AH K EY SH AH N Z
COMMUNISM	K AA M Y AH N IH Z AH M
COMMUNITIES	K AH M Y UW N AH T IY Z
COMMUNITIES(2)	K AH M Y UW N IH T IY Z
COMMUNITY	K AH M Y UW N AH T IY
COMMUNITY(2)	K AH M Y UW N IH T IY
COMMUTE	K AH M Y UW T
COMPANIES	K AH M P AH N IY Z
COMPANY	K AH M P AH N IY
COMPANY'S	K AH M P AH N IY Z
COMPARABLE	K AA M P ER AH B AH L
COMPARABLE(2)	K AH M P EH R AH B AH L
COMPARABLE(3)	K AH M P R AH B AH L
COMPARE	K AH M P EH R
COMPARED	K AH M P EH R D
COMPARISON	K AH M P EH R AH S AH N
COMPATIBLE	K AH M P AE T AH B AH L
COMPETE	K AH M P IY T
COMPETING	K AH M P IY T IH NG
COMPETITION	K AA M P AH T IH SH AH N
COMPETITIVE	K AH M P EH T AH T IH V
COMPETITIVE(2)	K AH M P EH T IH T IH V
COMPLAIN	K AH M P L EY N
COMPLAINING	K AH M P L EY N IH NG
COMPLAINTS	K AH M P L EY N T S
COMPLETE	K AH M P L IY T
COMPLETELY	K AH M P L IY T L IY
COMPLEX	K AA M P L EH K S
COMPLEX(2)	K AH M P L EH K S
COMPLICATED	K AA M P L AH K EY T AH D
COMPUTER	K AH M P Y UW T ER
COMPUTERIZED	K AH M P Y UW T ER AY Z D
COMPUTERS	K AH M P Y UW T ER Z
CONCENTRATE	K AA N S AH N T R EY T
CONCEPT	K AA N S EH P T
CONCERN	K AH N S ER N
CONCERNED	K AH N S ER N D
CONCERNS	K AH N S ER N Z
CONCERT	K AA N S ER T
CONCERT(2)	K AH N S ER T
CONCERTS	K AA N S ER T S
CONCERTS(2)	K AH N S ER T S
CONCLUSION	K AH N K L UW ZH AH N
CONCRETE	K AH N K R IY T
CONCRETE(2)	K AA N K R IY T
CONDITION	K AH N D IH SH AH N
CONDITIONED	K AH N D IH SH AH N D
CONDITIONER	K AH N D IH SH AH N ER
CONDITIONING	K AH N D IH SH AH N IH NG
CONDITIONS	K AH N D IH SH AH N Z
CONFERENCE	K AA N F ER AH N S
CONFERENCE(2)	K AA N F R AH N S
CONFIDENCE	K AA N F AH D AH N S
CONFIDENT	K AA N F AH D AH N T
CONFLICT	K AA N F L IH K T
CONFLICT(2)	K AH N F L IH K T
CONFUSED	K AH N F Y UW Z D
CONGRESS	K AA NG G R AH S
CONGRESSMAN	K AA NG G R AH S M AH N
CONNECTED	K AH N EH K T AH D
CONNECTED(2)	K AH N EH K T IH D
CONNECTICUT	K AH N EH T AH K AH T
CONNECTION	K AH N EH K SH AH N
CONSCIENTIOUS	K AA N SH IY EH N SH AH S
CONSCIOUS	K AA N SH AH S
CONSEQUENCES	K AA N S AH K W EH N S AH Z
CONSERVATIVE	K AH N S ER V AH T IH V
CONSIDER	K AH N S IH D ER
CONSIDERABLY	K AH N S IH D ER AH B L IY
CONSIDERATION	K AH N S IH D ER EY SH AH N
CONSIDERED	K AH N S IH D ER D
CONSIDERING	K AH N S IH D ER IH NG
CONSISTENT	K AH N S IH S T AH N T
CONSISTENTLY	K AH N S IH S T AH N T L IY
CONSTANT	K AA N S T AH N T
CONSTANTLY	K AA N S T AH N T L IY
CONSTITUTION	K AA N S T AH T UW SH AH N
CONSTRUCTION	K AH N S T R AH K SH AH N
CONSULTING	K AH N S AH L T IH NG
CONSUMER	K AH N S UW M ER
CONSUMING	K AH N S UW M IH NG
CONTACT	K AA N T AE K T
CONTACTS	K AA N T AE K T S
CONTACTS(2)	K AA N T AE K S
CONTAINER	K AH N T EY N ER
CONTAINERS	K AH N T EY N ER Z
CONTEMPORARY	K AH N T EH M P ER EH R IY
CONTENT	K AA N T EH N T
CONTENT(2)	K AH N T EH N T
CONTINENTAL	K AA N T AH N EH N T AH L
CONTINENTAL(2)	K AA N T AH N EH N AH L
CONTINUALLY	K AH N T IH N Y UW AH L IY
CONTINUALLY(2)	K AH N T IH N Y UW L IY
CONTINUE	K AH N T IH N Y UW
CONTINUED	K AH N T IH N Y UW D
CONTINUES	K AH N T IH N Y UW Z
CONTRACT	K AA N T R AE K T
CONTRACT(2)	K AH N T R AE K T
CONTRACTOR	K AA N T R AE K T ER
CONTRACTS	K AA N T R AE K T S
CONTRACTS(2)	K AH N T R AE K T S
CONTRIBUTE	K AH N T R IH B Y UW T
CONTRIBUTING	K AH N T R IH B Y UW T IH NG
CONTRIBUTION	K AA N T R AH B Y UW SH AH N
CONTROL	K AH N T R OW L
CONTROLLED	K AH N T R OW L D
CONTROLLING	K AH N T R OW L IH NG
CONTROLS	K AH N T R OW L Z
CONTROVERSIAL	K AA N T R AH V ER SH AH L
CONTROVERSY	K AA N T R AH V ER S IY
CONVENIENCE	K AH N V IY N Y AH N S
CONVENIENT	K AH N V IY N Y AH N T
CONVERSATION	K AA N V ER S EY SH AH N
CONVERSATIONS	K AA N V ER S EY SH AH N Z
CONVERSION	K AH N V ER ZH AH N
CONVERT	K AA N V ER T
CONVERT(2)	K AH N V ER T
CONVERTED	K AH N V ER T IH D
CONVERTIBLE	K AH N V ER T AH B AH L
CONVICT	K AA N V IH K T
CONVICT(2)	K AH N V IH K T
CONVICTED	K AH N V IH K T AH D
CONVINCE	K AH N V IH N S
CONVINCED	K AH N V IH N S T
COOK	K UH K
COOKBOOK	K UH K B UH K
COOKBOOKS	K UH K B UH K S
COOKED	K UH K T
COOKIES	K UH K IY Z
COOKING	K UH K IH NG
COOKS	K UH K S
COOL	K UW L
COOLER	K UW L ER
COP	K AA P
COPE	K OW P
COPS	K AA P S
COPY	K AA P IY
CORE	K AO R
CORN	K AO R N
CORNER	K AO R N ER
CORPORATE	K AO R P ER AH T
CORPORATE(2)	K AO R P R AH T
CORPORATION	K AO R P ER EY SH AH N
CORPORATIONS	K AO R P ER EY SH AH N Z
CORPS	K AO R
CORPS(2)	K AO R Z
CORPUS	K AO R P AH S
CORRECT	K ER EH K T
CORRECTLY	K ER EH K T L IY
CORRUPT	K ER AH P T
CORRUPTION	K ER AH P SH AH N
COSBY	K AO Z B IY
COST	K AA S T
COST(2)	K AO S T
COSTING	K AO S T IH NG
COSTNER	K AA S T N ER
COSTS	K AA S T S
COSTS(2)	K AO S T S
COSTS(3)	K AO S S
COSTS(4)	K AO S
COTTON	K AA T AH N
COTTON(2)	K AO T AH N
COUCH	K AW CH
COULD	K UH D
COULDN'T	K UH D AH N T
COULDN'T(2)	K UH D AH N
COUNCIL	K AW N S AH L
COUNSELING	K AW N S AH L IH NG
COUNSELING(2)	K AW N S L IH NG
COUNSELOR	K AW N S AH L ER
COUNT	K AW N T
COUNTER	K AW N T ER
COUNTIES	K AW N T IY Z
COUNTIES(2)	K AW N IY Z
COUNTING	K AW N T IH NG
COUNTING(2)	K AW N IH NG
COUNTRIES	K AH N T R IY Z
COUNTRY	K AH N T R IY
COUNTRY'S	K AH N T R IY Z
COUNTS	K AW N T S
COUNTY	K AW N T IY
COUNTY(2)	K AW N IY
COUPLE	K AH P AH L
COUPLES	K AH P AH L Z
COUPONS	K UW P AO N Z
COUPONS(2)	K Y UW P AO N Z
COURSE	K AO R S
COURSES	K AO R S AH Z
COURSES(2)	K AO R S IH Z
COURT	K AO R T
COURTS	K AO R T S
COUSIN	K AH Z AH N
COUSINS	K AH Z AH N Z
COVER	K AH V ER
COVERAGE	K AH V ER AH JH
COVERAGE(2)	K AH V ER IH JH
COVERAGE(3)	K AH V R IH JH
COVERED	K AH V ER D
COVERING	K AH V ER IH NG
COVERING(2)	K AH V R IH NG
COVERS	K AH V ER Z
COW	K AW
COWBOY	K AW B OY
COWBOYS	K AW B OY Z
CRAB	K R AE B
CRACK	K R AE K
CRAFT	K R AE F T
CRAFTS	K R AE F T S
CRAFTS(2)	K R AE F S
CRAP	K R AE P
CRAWFISH	K R AO F IH SH
CRAWL	K R AO L
CRAZY	K R EY Z IY
CREAM	K R IY M
CREATE	K R IY EY T
CREATED	K R IY EY T AH D
CREATED(2)	K R IY EY T IH D
CREATIVE	K R IY EY T IH V
CREDIT	K R EH D AH T
CREDIT(2)	K R EH D IH T
CREEK	K R IY K
CREW	K R UW
CRIED	K R AY D
CRIME	K R AY M
CRIMES	K R AY M Z
CRIMINAL	K R IH M AH N AH L
CRIMINALS	K R IH M AH N AH L Z
CRISIS	K R AY S AH S
CRITERIA	K R AY T IH R IY AH
CRITICAL	K R IH T IH K AH L
CROCHET	K R OW SH EY
CROP	K R AA P
CROPS	K R AA P S
CROSS	K R AO S
CROSSED	K R AO S T
CROWD	K R AW D
CROWDED	K R AW D AH D
CROWDED(2)	K R AW D IH D
CROWDS	K R AW D Z
CROWN	K R AW N
CRUEL	K R UW AH L
CRUEL(2)	K R UW L
CRUISE	K R UW Z
CRY	K R AY
CRYING	K R AY IH NG
CUCUMBERS	K Y UW K AH M ER Z
CULTURAL	K AH L CH ER AH L
CULTURE	K AH L CH ER
CULTURES	K AH L CH ER Z
CUP	K AH P
CUPS	K AH P S
CURB	K ER B
CURBSIDE	K ER B S AY D
CURE	K Y UH R
CURIOUS	K Y UH R IY AH S
CURRENT	K ER AH N T
CURRENT(2)	K ER N T
CURRENT(3)	K AA R AH N T
CURRENTLY	K ER AH N T L IY
CURRICULUM	K ER IH K Y AH L AH M
CUSTOMER	K AH S T AH M ER
CUSTOMERS	K AH S T AH M ER Z
CUT	K AH T
CUTE	K Y UW T
CUTS	K AH T S
CUTTING	K AH T IH NG
CYCLE	S AY K AH L
CYLINDER	S IH L AH N D ER
CYLINDER(2)	S IH L IH N D ER
D.	D IY
DA	D AA
DA(2)	D IY EY
DAD	D AE D
DAD'S	D AE D Z
DADDY	D AE D IY
DAILY	D EY L IY
DAKOTA	D AH K OW T AH
DALLAS	D AE L AH S
DAMAGE	D AE M AH JH
DAMAGE(2)	D AE M IH JH
DAMN	D AE M
DAN	D AE N
DANCE	D AE N S
DANCES	D AE N S AH Z
DANCES(2)	D AE N S IH Z
DANCING	D AE N S IH NG
DANGER	D EY N JH ER
DANGEROUS	D EY N JH ER AH S
DARK	D AA R K
DARN	D AA R N
DARNED	D AA R N D
DATA	D EY T AH
DATA(2)	D AE T AH
DATE	D EY T
DAUGHTER	D AO T ER
DAUGHTER'S	D AO T ER Z
DAUGHTERS	D AO T ER Z
DAVE	D EY V
DAVID	D EY V IH D
DAVIS	D EY V AH S
DAVIS(2)	D EY V IH S
DAY	D EY
DAYCARE	D EY K EH R
DAYS	D EY Z
DAYTIME	D EY T AY M
DAYTON	D EY T AH N
DE	D IY
DE(2)	D EY
DE(3)	D AH
DEAD	D EH D
DEAL	D IY L
DEALER	D IY L ER
DEALERS	D IY L ER Z
DEALERSHIP	D IY L ER SH IH P
DEALING	D IY L IH NG
DEALS	D IY L Z
DEALT	D EH L T
DEAR	D IH R
DEATH	D EH TH
DEBATE	D AH B EY T
DEBT	D EH T
DEBTS	D EH T S
DECEMBER	D IH S EH M B ER
DECENT	D IY S AH N T
DECIDE	D IH S AY D
DECIDED	D IH S AY D IH D
DECIDES	D IH S AY D Z
DECIDING	D AH S AY D IH NG
DECISION	D IH S IH ZH AH N
DECISIONS	D IH S IH ZH AH N Z
DECK	D EH K
DECORATING	D EH K ER EY T IH NG
DEDICATED	D EH D AH K EY T AH D
DEDUCT	D IH D AH K T
DEDUCTIBLE	D IH D AH K T AH B AH L
DEDUCTIONS	D IH D AH K SH AH N Z
DEEP	D IY P
DEER	D IH R
DEFEND	D IH F EH N D
DEFENSE	D IH F EH N S
DEFENSIVE	D IH F EH N S IH V
DEFICIT	D EH F AH S AH T
DEFINITE	D EH F AH N AH T
DEFINITELY	D EH F AH N AH T L IY
DEGREE	D IH G R IY
DEGREES	D IH G R IY Z
DELICIOUS	D IH L IH SH AH S
DELIVERED	D IH L IH V ER D
DEMAND	D IH M AE N D
DEMOCRACY	D IH M AA K R AH S IY
DEMOCRAT	D EH M AH K R AE T
DEMOCRATIC	D EH M AH K R AE T IH K
DEMOCRATS	D EH M AH K R AE T S
DENTAL	D EH N T AH L
DENTAL(2)	D EH N AH L
DENTIST	D EH N T AH S T
DENTIST(2)	D EH N T IH S T
DENTIST(3)	D EH N IH S T
DENTON	D EH N T AH N
DENVER	D EH N V ER
DEPARTMENT	D IH P AA R T M AH N T
DEPARTMENTS	D IH P AA R T M AH N T S
DEPEND	D IH P EH N D
DEPENDENT	D IH P EH N D AH N T
DEPENDING	D IH P EH N D IH NG
DEPENDS	D IH P EH N D Z
DEPOSIT	D AH P AA Z IH T
DEPOSIT(2)	D IH P AA Z AH T
DEPRESSED	D IH P R EH S T
DEPRESSING	D IH P R EH S IH NG
DEPRESSION	D IH P R EH SH AH N
DEPTH	D EH P TH
DESCRIBE	D IH S K R AY B
DESERT	D EH Z ER T
DESERT(2)	D IH Z ER T
DESERVE	D IH Z ER V
DESIGN	D IH Z AY N
DESIGNED	D IH Z AY N D
DESIGNING	D IH Z AY N IH NG
DESIRE	D IH Z AY ER
DESK	D EH S K
DESSERT	D IH Z ER T
DESSERTS	D IH Z ER T S
DESTROY	D IH S T R OY
DESTROYED	D IH S T R OY D
DETAIL	D IH T EY L
DETAIL(2)	D IY T EY L
DETAILS	D IH T EY L Z
DETAILS(2)	D IY T EY L Z
DETERMINE	D AH T ER M AH N
DETERMINE(2)	D IH T ER M AH N
DETERMINED	D IH T ER M AH N D
DETERRENT	D IH T ER R AH N T
DETROIT	D IH T R OY T
DETROIT(2)	D IY T R OY T
DEVELOP	D IH V EH L AH P
DEVELOPED	D IH V EH L AH P T
DEVELOPING	D IH V EH L AH P IH NG
DEVELOPMENT	D IH V EH L AH P M AH N T
DIAL	D AY AH L
DIAL(2)	D AY L
DIAPERS	D AY AH P ER Z
DIAPERS(2)	D AY P ER Z
DICK	D IH K
DID	D IH D
DID(2)	D IH D
DIDN'T	D IH D AH N T
DIDN'T(2)	D IH D N T
DIDN'T(3)	D IH D AH N
DIDN'T(4)	D IH N T
DIE	D AY
DIED	D AY D
DIEGO	D IY EY G OW
DIES	D AY Z
DIESEL	D IY S AH L
DIESEL(2)	D IY Z AH L
DIET	D AY AH T
DIFFERENCE	D IH F ER AH N S
DIFFERENCE(2)	D IH F R AH N S
DIFFERENCES	D IH F ER AH N S IH Z
DIFFERENCES(2)	D IH F R AH N S AH Z
DIFFERENT	D IH F ER AH N T
DIFFERENT(2)	D IH F R AH N T
DIFFERENTLY	D IH F R AH N T L IY
DIFFERENTLY(2)	D IH F ER EH N T L IY
DIFFICULT	D IH F AH K AH L T
DIFFICULTY	D IH F AH K AH L T IY
DIFFICULTY(2)	D IH F IH K AH L T IY
DIG	D IH G
DIGEST	D AY JH EH S T
DIGEST(2)	D AY JH EH S T
DIGGING	D IH G IH NG
DIME	D AY M
DINING	D AY N IH NG
DINNER	D IH N ER
DINNERS	D IH N ER Z
DIP	D IH P
DIRECT	D ER EH K T
DIRECT(2)	D AY R EH K T
DIRECT(3)	D IY R EH K T
DIRECT(4)	D IH R EH K T
DIRECTED	D ER EH K T AH D
DIRECTED(2)	D ER EH K T IH D
DIRECTED(3)	D AY R EH K T IH D
DIRECTED(4)	D IY R EH K T IH D
DIRECTED(5)	D IH R EH K T IH D
DIRECTION	D ER EH K SH AH N
DIRECTION(2)	D IY R EH K SH IH N
DIRECTION(3)	D AY R EH K SH IH N
DIRECTION(4)	D IH R EH K SH IH N
DIRECTIONS	D ER EH K SH AH N Z
DIRECTIONS(2)	D IY R EH K SH IH N Z
DIRECTIONS(3)	D AY R EH K SH IH N Z
DIRECTIONS(4)	D IH R EH K SH IH N Z
DIRECTLY	D ER EH K T L IY
DIRECTLY(2)	D IY R EH K L IY
DIRECTLY(3)	D AY R EH K L IY
DIRECTLY(4)	D IH R EH K L IY
DIRECTOR	D ER EH K T ER
DIRECTOR(2)	D AY R EH K T ER
DIRECTOR(3)	D IY R EH K T ER
DIRECTOR(4)	D IH R EH K T ER
DIRT	D ER T
DIRTY	D ER T IY
DISABILITY	D IH S AH B IH L IH T IY
DISABILITY(2)	D IH S AH B IH L IH T IY Z
DISAGREE	D IH S AH G R IY
DISAPPOINTED	D IH S AH P OY N T IH D
DISAPPOINTED(2)	D IH S AH P OY N IH D
DISASTER	D IH Z AE S T ER
DISC	D IH S K
DISCIPLINE	D IH S AH P L AH N
DISCOUNT	D IH S K AW N T
DISCOUNT(2)	D IH S K AW N T
DISCOVER	D IH S K AH V ER
DISCOVERED	D IH S K AH V ER D
DISCUSS	D IH S K AH S
DISCUSSED	D IH S K AH S T
DISCUSSING	D IH S K AH S IH NG
DISCUSSION	D IH S K AH SH AH N
DISEASE	D IH Z IY Z
DISEASES	D IH Z IY Z AH Z
DISEASES(2)	D IH Z IY Z IH Z
DISGUSTING	D IH S G AH S T IH NG
DISH	D IH SH
DISHES	D IH SH AH Z
DISHES(2)	D IH SH IH Z
DISK	D IH S K
DISNEY	D IH Z N IY
DISPLAY	D IH S P L EY
DISPOSABLE	D IH S P OW Z AH B AH L
DISTANCE	D IH S T AH N S
DISTRICT	D IH S T R IH K T
DISTRICTS	D IH S T R IH K T S
DIVIDE	D IH V AY D
DIVISION	D IH V IH ZH AH N
DIVORCE	D IH V AO R S
DIVORCED	D IH V AO R S T
DO	D UW
DOCTOR	D AA K T ER
DOCTOR(2)	D AO K T ER
DOCTOR'S	D AA K T ER Z
DOCTORS	D AA K T ER Z
DODGE	D AA JH
DOES	D AH Z
DOES(2)	D IH Z
DOESN'T	D AH Z AH N T
DOESN'T(2)	D AH Z AH N
DOG	D AO G
DOGS	D AA G Z
DOGS(2)	D AO G Z
DOING	D UW IH NG
DOLLAR	D AA L ER
DOLLAR(2)	D AO L ER
DOLLARS	D AA L ER Z
DOLLARS(2)	D AO L ER Z
DOLLS	D AA L Z
DOMESTIC	D AH M EH S T IH K
DON'T	D OW N T
DON'T(2)	D OW N
DONE	D AH N
DOOR	D AO R
DOORS	D AO R Z
DORM	D AO R M
DOUBLE	D AH B AH L
DOUBT	D AW T
DOUG	D AH G
DOWN	D AW N
DOWNHILL	D AW N HH IH L
DOWNSTAIRS	D AW N S T EH R Z
DOWNTOWN	D AW N T AW N
DOZEN	D AH Z AH N
DRAFT	D R AE F T
DRAG	D R AE G
DRAIN	D R EY N
DRAMATIC	D R AH M AE T IH K
DRAMATICALLY	D R AH M AE T IH K L IY
DRAMATICALLY(2)	D R AH M AE T IH K AH L IY
DRASTIC	D R AE S T IH K
DRASTICALLY	D R AE S T IH K L IY
DRAW	D R AO
DRAWBACK	D R AO B AE K
DRAWING	D R AO IH NG
DREAM	D R IY M
DREAMS	D R IY M Z
DRESS	D R EH S
DRESSED	D R EH S T
DRESSES	D R EH S AH Z
DRESSES(2)	D R EH S IH Z
DRESSING	D R EH S IH NG
DRESSY	D R EH S IY
DRIED	D R AY D
DRILL	D R IH L
DRINK	D R IH NG K
DRINKING	D R IH NG K IH NG
DRINKS	D R IH NG K S
DRIVE	D R AY V
DRIVEN	D R IH V AH N
DRIVER	D R AY V ER
DRIVER'S	D R AY V ER Z
DRIVERS	D R AY V ER Z
DRIVES	D R AY V Z
DRIVEWAY	D R AY V W EY
DRIVING	D R AY V IH NG
DROP	D R AA P
DROP(2)	D R AO P
DROPPED	D R AA P T
DROPPING	D R AA P IH NG
DROVE	D R OW V
DRUG	D R AH G
DRUGS	D R AH G Z
DRUNK	D R AH NG K
DRY	D R AY
DRYER	D R AY ER
DUE	D UW
DUE(2)	D Y UW
DUG	D AH G
DUKAKIS	D UW K AA K IH S
DUKE	D UW K
DUMB	D AH M
DUMP	D AH M P
DUMPING	D AH M P IH NG
DUPLEX	D UW P L EH K S
DURING	D UH R IH NG
DURING(2)	D Y UH R IH NG
DURING(3)	D ER IH NG
DUST	D AH S T
DUTY	D UW T IY
DUTY(2)	D Y UW T IY
DYING	D AY IH NG
E.	IY
EACH	IY CH
EAGLE	IY G AH L
EAGLES	IY G AH L Z
EAR	IH R
EAR(2)	IY R
EARLIER	ER L IY ER
EARLY	ER L IY
EARN	ER N
EARNED	ER N D
EARS	IH R Z
EARS(2)	IY R Z
EARTH	ER TH
EASIER	IY Z IY ER
EASILY	IY Z AH L IY
EAST	IY S T
EASTER	IY S T ER
EASTERN	IY S T ER N
EASY	IY Z IY
EAT	IY T
EATEN	IY T AH N
EATING	IY T IH NG
EATS	IY T S
ECONOMIC	EH K AH N AA M IH K
ECONOMIC(2)	IY K AH N AA M IH K
ECONOMICAL	EH K AH N AA M IH K AH L
ECONOMICAL(2)	IY K AH N AA M IH K AH L
ECONOMICALLY	EH K AH N AA M IH K L IY
ECONOMICALLY(2)	IY K AH N AA M IH K L IY
ECONOMICS	EH K AH N AA M IH K S
ECONOMICS(2)	IY K AH N AA M IH K S
ECONOMY	IH K AA N AH M IY
ECONOMY(2)	IY K AA N AH M IY
ED	EH D
EDGE	EH JH
EDITOR	EH D AH T ER
EDITOR(2)	EH D IH T ER
EDUCATE	EH JH AH K EY T
EDUCATE(2)	EH JH Y UW K EY T
EDUCATED	EH JH AH K EY T AH D
EDUCATED(2)	EH JH Y UW K EY T AH D
EDUCATION	EH JH AH K EY SH AH N
EDUCATION(2)	EH JH Y UW K EY SH AH N
EDUCATIONAL	EH JH AH K EY SH AH N AH L
EDUCATIONAL(2)	EH JH Y UW K EY SH AH N AH L
EFFECT	IH F EH K T
EFFECT(2)	IY F EH K T
EFFECT(3)	AH F EH K T
EFFECTIVE	IH F EH K T IH V
EFFECTIVE(2)	IY F EH K T IH V
EFFECTS	IH F EH K T S
EFFECTS(2)	IH F EH K S
EFFECTS(3)	IY F EH K T S
EFFECTS(4)	IY F EH K S
EFFICIENT	IH F IH SH AH N T
EFFORT	EH F ER T
EGG	EH G
EGGS	EH G Z
EIGHT	EY T
EIGHTEEN	EY T IY N
EIGHTEEN(2)	EY T IY N
EIGHTH	EY T TH
EIGHTH(2)	EY TH
EIGHTIES	EY T IY Z
EIGHTY	EY T IY
EITHER	IY DH ER
EITHER(2)	AY DH ER
EL	EH L
ELABORATE	IH L AE B R AH T
ELABORATE(2)	IH L AE B ER EY T
ELDERLY	EH L D ER L IY
ELECTED	IH L EH K T AH D
ELECTED(2)	IH L EH K T IH D
ELECTION	IH L EH K SH AH N
ELECTIONS	IH L EH K SH AH N Z
ELECTRIC	IH L EH K T R IH K
ELECTRICAL	IH L EH K T R IH K AH L
ELECTRICITY	IH L EH K T R IH S AH T IY
ELECTRONIC	IH L EH K T R AA N IH K
ELECTRONICS	IH L EH K T R AA N IH K S
ELEMENT	EH L AH M AH N T
ELEMENTARY	EH L AH M EH N T R IY
ELEMENTARY(2)	EH L AH M EH N T ER R IY
ELEMENTARY(3)	EH L AH M EH N CH R IY
ELEVEN	IH L EH V AH N
ELEVEN(2)	IY L EH V AH N
ELIGIBLE	EH L AH JH AH B AH L
ELIGIBLE(2)	EH L IH JH AH B AH L
ELIMINATE	IH L IH M AH N EY T
ELSE	EH L S
ELSE'S	EH L S IH Z
ELSEWHERE	EH L S W EH R
EMBARRASSED	IH M B EH R AH S T
EMBARRASSING	IH M B EH R AH S IH NG
EMERGENCIES	IH M ER JH AH N S IY Z
EMERGENCIES(2)	IY M ER JH AH N S IY Z
EMERGENCY	IH M ER JH AH N S IY
EMERGENCY(2)	IY M ER JH AH N S IY
EMISSIONS	IH M IH SH AH N Z
EMOTIONAL	IH M OW SH AH N AH L
EMOTIONAL(2)	IY M OW SH AH N AH L
EMOTIONALLY	IH M OW SH N AH L IY
EMOTIONALLY(2)	IY M OW SH N AH L IY
EMOTIONS	IH M OW SH AH N Z
EMOTIONS(2)	IY M OW SH AH N Z
EMPHASIS	EH M F AH S AH S
EMPHASIS(2)	EH M F AH S IH S
EMPLOYED	EH M P L OY D
EMPLOYED(2)	IH M P L OY D
EMPLOYEE	EH M P L OY IY
EMPLOYEE(2)	IH M P L OY IY
EMPLOYEES	EH M P L OY IY Z
EMPLOYEES(2)	IH M P L OY IY Z
EMPLOYER	EH M P L OY ER
EMPLOYER(2)	IH M P L OY ER
EMPLOYERS	EH M P L OY ER Z
EMPLOYERS(2)	IH M P L OY ER Z
EMPLOYMENT	EH M P L OY M AH N T
EMPLOYMENT(2)	IH M P L OY M AH N T
EMPTY	EH M P T IY
EMPTY(2)	EH M T IY
ENCOURAGE	EH N K ER IH JH
ENCOURAGE(2)	IH N K ER AH JH
ENCOURAGED	EH N K ER IH JH D
ENCOURAGED(2)	IH N K ER AH JH D
ENCOURAGING	EH N K ER IH JH IH NG
ENCOURAGING(2)	IH N K ER AH JH IH NG
END	EH N D
ENDED	EH N D AH D
ENDED(2)	EH N D IH D
ENDING	EH N D IH NG
ENDS	EH N D Z
ENEMY	EH N AH M IY
ENERGY	EH N ER JH IY
ENFORCE	EH N F AO R S
ENFORCED	EH N F AO R S T
ENFORCEMENT	EH N F AO R S M AH N T
ENGAGED	EH N G EY JH D
ENGINE	EH N JH AH N
ENGINE(2)	IH N JH AH N
ENGINEER	EH N JH AH N IH R
ENGINEERING	EH N JH AH N IH R IH NG
ENGINEERS	EH N JH AH N IH R Z
ENGINES	EH N JH AH N Z
ENGLAND	IH NG G L AH N D
ENGLISH	IH NG G L IH SH
ENGLISH(2)	IH NG L IH SH
ENJOY	EH N JH OY
ENJOY(2)	IH N JH OY
ENJOYABLE	EH N JH OY AH B AH L
ENJOYED	EH N JH OY D
ENJOYED(2)	IH N JH OY D
ENJOYING	EH N JH OY IH NG
ENJOYING(2)	IH N JH OY IH NG
ENJOYMENT	EH N JH OY M AH N T
ENJOYMENT(2)	IH N JH OY M AH N T
ENJOYS	EH N JH OY Z
ENJOYS(2)	IH N JH OY Z
ENORMOUS	IH N AO R M AH S
ENORMOUS(2)	IH N AO R M IH S
ENORMOUS(3)	IY N AO R M AH S
ENORMOUS(4)	IY N AO R M IH S
ENOUGH	IH N AH F
ENOUGH(2)	IY N AH F
ENTER	EH N T ER
ENTER(2)	EH N ER
ENTERING	EH N T ER IH NG
ENTERING(2)	EH N ER IH NG
ENTERTAIN	EH N T ER T EY N
ENTERTAIN(2)	EH N ER T EY N
ENTERTAINED	EH N T ER T EY N D
ENTERTAINED(2)	EH N ER T EY N D
ENTERTAINING	EH N T ER T EY N IH NG
ENTERTAINING(2)	EH N ER T EY N IH NG
ENTERTAINMENT	EH N T ER T EY N M AH N T
ENTERTAINMENT(2)	EH N ER T EY N M AH N T
ENTIRE	IH N T AY ER
ENTIRELY	IH N T AY ER L IY
ENTRY	EH N T R IY
ENVELOPE	EH N V AH L OW P
ENVIRONMENT	IH N V AY R AH N M AH N T
ENVIRONMENTAL	IH N V AY R AH N M EH N T AH L
ENVIRONMENTAL(2)	IH N V AY R AH N M EH N AH L
EPISODE	EH P AH S OW D
EPISODE(2)	EH P IH S OW D
EQUAL	IY K W AH L
EQUALLY	IY K W AH L IY
EQUIPMENT	IH K W IH P M AH N T
EQUIVALENT	IH K W IH V AH L AH N T
ER	ER
ERA	EH R AH
ERA(2)	IH R AH
ERROR	EH R ER
ESCAPE	IH S K EY P
ESPECIALLY	AH S P EH SH L IY
ESPECIALLY(2)	AH S P EH SH AH L IY
ESSENTIALLY	IH S EH N SH AH L IY
ESSENTIALLY(2)	IY S EH N SH AH L IY
ESTABLISH	IH S T AE B L IH SH
ESTABLISH(2)	IY S T AE B L IH SH
ESTABLISHED	IH S T AE B L IH SH T
ESTABLISHED(2)	IY S T AE B L IH SH T
ESTATE	IH S T EY T
ESTEEM	AH S T IY M
ET	EH T
ETHNIC	EH TH N IH K
EUROPE	Y UH R AH P
EUROPEAN	Y UH R AH P IY AH N
EVE	IY V
EVEN	IY V IH N
EVENING	IY V N IH NG
EVENINGS	IY V N IH NG Z
EVENT	IH V EH N T
EVENT(2)	IY V EH N T
EVENTS	IH V EH N T S
EVENTS(2)	IY V EH N T S
EVENTUALLY	IH V EH N CH AH W AH L IY
EVENTUALLY(2)	IH V EH N SH AH L IY
EVENTUALLY(3)	IY V EH N CH AH W AH L IY
EVENTUALLY(4)	IY V EH N SH AH L IY
EVER	EH V ER
EVERY	EH V ER IY
EVERY(2)	EH V R IY
EVERYBODY	EH V R IY B AA D IY
EVERYBODY'S	EH V R IY B AA D IY Z
EVERYDAY	EH V R IY D EY
EVERYONE	EH V R IY W AH N
EVERYONE'S	EH V R IY W AH N Z
EVERYTHING	EH V R IY TH IH NG
EVERYTHING'S	EH V R IY TH IH NG Z
EVERYWHERE	EH V R IY W EH R
EVERYWHERE(2)	EH V R IY HH W EH R
EVIDENCE	EH V AH D AH N S
EVIDENTLY	EH V AH D AH N T L IY
EX	EH K S
EXACT	IH G Z AE K T
EXACTLY	IH G Z AE K T L IY
EXAMPLE	IH G Z AE M P AH L
EXCELLENT	EH K S AH L AH N T
EXCEPT	IH K S EH P T
EXCEPTION	IH K S EH P SH AH N
EXCHANGE	IH K S CH EY N JH
EXCITED	IH K S AY T AH D
EXCITED(2)	IH K S AY T IH D
EXCITING	IH K S AY T IH NG
EXCUSE	IH K S K Y UW S
EXCUSE(2)	IH K S K Y UW Z
EXECUTE	EH K S AH K Y UW T
EXECUTED	EH K S AH K Y UW T AH D
EXECUTED(2)	EH K S AH K Y UW T IH D
EXECUTIVE	IH G Z EH K Y AH T IH V
EXERCISE	EH K S ER S AY Z
EXERCISING	EH K S ER S AY Z IH NG
EXHAUSTED	IH G Z AO S T AH D
EXHAUSTED(2)	IH G Z AO S T IH D
EXIST	IH G Z IH S T
EXISTS	IH G Z IH S T S
EXISTS(2)	IH G Z IH S S
EXISTS(3)	IH G Z IH S
EXPECT	IH K S P EH K T
EXPECTED	IH K S P EH K T AH D
EXPECTED(2)	IH K S P EH K T IH D
EXPECTING	IH K S P EH K T IH NG
EXPENSE	IH K S P EH N S
EXPENSES	IH K S P EH N S AH Z
EXPENSES(2)	IH K S P EH N S IH Z
EXPENSIVE	IH K S P EH N S IH V
EXPERIENCE	IH K S P IH R IY AH N S
EXPERIENCED	IH K S P IH R IY AH N S T
EXPERIENCES	IH K S P IH R IY AH N S IH Z
EXPERIMENT	IH K S P EH R AH M AH N T
EXPERT	EH K S P ER T
EXPERTISE	EH K S P ER T IY Z
EXPERTS	EH K S P ER T S
EXPLAIN	IH K S P L EY N
EXPOSED	IH K S P OW Z D
EXPOSURE	IH K S P OW ZH ER
EXPRESS	IH K S P R EH S
EXPRESSWAY	IH K S P R EH S W EY
EXTEND	IH K S T EH N D
EXTENDED	IH K S T EH N D AH D
EXTENDED(2)	IH K S T EH N D IH D
EXTENSION	IH K S T EH N SH AH N
EXTENSIVE	IH K S T EH N S IH V
EXTENT	IH K S T EH N T
EXTRA	EH K S T R AH
EXTREME	IH K S T R IY M
EXTREMELY	IH K S T R IY M L IY
EYE	AY
EYES	AY Z
F.	EH F
FABRIC	F AE B R IH K
FABULOUS	F AE B Y AH L AH S
FACE	F EY S
FACED	F EY S T
FACILITIES	F AH S IH L AH T IY Z
FACILITIES(2)	F AH S IH L IH T IY Z
FACILITY	F AH S IH L IH T IY
FACING	F EY S IH NG
FACT	F AE K T
FACTOR	F AE K T ER
FACTORIES	F AE K T ER IY Z
FACTORS	F AE K T ER Z
FACTORY	F AE K T ER IY
FACTS	F AE K T S
FACTS(2)	F AE K S
FAIL	F EY L
FAILED	F EY L D
FAILING	F EY L IH NG
FAILURE	F EY L Y ER
FAIR	F EH R
FAIRLY	F EH R L IY
FAJITAS	F AH JH IY T AH Z
FAJITAS(2)	F AH HH IY T AH Z
FALL	F AO L
FALL(2)	F AA L
FALLEN	F AA L AH N
FALLING	F AA L IH NG
FALLS	F AO L Z
FALSE	F AO L S
FAMILIAR	F AH M IH L Y ER
FAMILIES	F AE M AH L IY Z
FAMILIES(2)	F AE M L IY Z
FAMILY	F AE M AH L IY
FAMILY(2)	F AE M L IY
FAMILY'S	F AE M AH L IY Z
FAMILY'S(2)	F AE M L IY Z
FAMOUS	F EY M AH S
FAN	F AE N
FANCY	F AE N S IY
FANS	F AE N Z
FANTASTIC	F AE N T AE S T IH K
FAR	F AA R
FARM	F AA R M
FARMERS	F AA R M ER Z
FARMING	F AA R M IH NG
FARMS	F AA R M Z
FARTHER	F AA R DH ER
FASCINATED	F AE S AH N EY T AH D
FASCINATED(2)	F AE S AH N EY T IH D
FASCINATING	F AE S AH N EY T IH NG
FASHION	F AE SH AH N
FASHIONED	F AE SH AH N D
FAST	F AE S T
FASTER	F AE S T ER
FAT	F AE T
FATHER	F AA DH ER
FATHER'S	F AA DH ER Z
FATHERS	F AA DH ER Z
FAULT	F AO L T
FAVOR	F EY V ER
FAVORITE	F EY V ER IH T
FAVORITE(2)	F EY V R AH T
FAVORITES	F EY V ER IH T S
FAVORITES(2)	F EY V R AH T S
FEAR	F IH R
FEASIBLE	F IY Z AH B AH L
FEATURES	F IY CH ER Z
FEBRUARY	F EH B Y AH W EH R IY
FEBRUARY(2)	F EH B AH W EH R IY
FEBRUARY(3)	F EH B R UW W EH R IY
FEBRUARY(4)	F EH B UW W EH R IY
FEBRUARY(5)	F EH B Y UW W EH R IY
FED	F EH D
FEDERAL	F EH D ER AH L
FEDERAL(2)	F EH D R AH L
FEE	F IY
FEED	F IY D
FEEDING	F IY D IH NG
FEEL	F IY L
FEELING	F IY L IH NG
FEELINGS	F IY L IH NG Z
FEELS	F IY L Z
FEES	F IY Z
FEET	F IY T
FELL	F EH L
FELLOW	F EH L OW
FELT	F EH L T
FEMALE	F IY M EY L
FENCE	F EH N S
FERTILIZER	F ER T AH L AY Z ER
FEW	F Y UW
FEWER	F Y UW ER
FIANCE	F IY AA N S EY
FIANCE(2)	F IY AA N S EY
FIANCEE	F IY AE N S IY
FICTION	F IH K SH AH N
FIELD	F IY L D
FIELDS	F IY L D Z
FIFTEEN	F IH F T IY N
FIFTEEN(2)	F IH F T IY N
FIFTEENTH	F IH F T IY N TH
FIFTH	F IH F TH
FIFTH(2)	F IH TH
FIFTIES	F IH F T IY Z
FIFTY	F IH F T IY
FIGHT	F AY T
FIGHTING	F AY T IH NG
FIGHTS	F AY T S
FIGURE	F IH G Y ER
FIGURED	F IH G Y ER D
FIGURES	F IH G Y ER Z
FIGURING	F IH G Y ER IH NG
FILE	F AY L
FILES	F AY L Z
FILL	F IH L
FILLED	F IH L D
FILLING	F IH L IH NG
FILM	F IH L M
FILMS	F IH L M Z
FILTER	F IH L T ER
FINAL	F AY N AH L
FINALLY	F AY N AH L IY
FINANCE	F AH N AE N S
FINANCE(2)	F IH N AE N S
FINANCE(3)	F AY N AE N S
FINANCES	F IH N AE N S IH Z
FINANCES(2)	F AY N AE N S IH Z
FINANCIAL	F AH N AE N SH AH L
FINANCIAL(2)	F IH N AE N SH AH L
FINANCIAL(3)	F AY N AE N SH AH L
FINANCIALLY	F AH N AE N SH AH L IY
FINANCIALLY(2)	F IH N AE N SH AH L IY
FINANCIALLY(3)	F AY N AE N SH AH L IY
FIND	F AY N D
FINDING	F AY N D IH NG
FINDS	F AY N D Z
FINE	F AY N
FINGER	F IH NG G ER
FINGERS	F IH NG G ER Z
FINISH	F IH N IH SH
FINISHED	F IH N IH SH T
FINISHING	F IH N IH SH IH NG
FIRE	F AY ER
FIRE(2)	F AY R
FIREARMS	F AY ER AA R M Z
FIREARMS(2)	F AY R AA R M Z
FIRED	F AY ER D
FIRING	F AY R IH NG
FIRING(2)	F AY ER R IH NG
FIRM	F ER M
FIRST	F ER S T
FISH	F IH SH
FISHED	F IH SH T
FISHER	F IH SH ER
FISHING	F IH SH IH NG
FIT	F IH T
FITNESS	F IH T N AH S
FITS	F IH T S
FIVE	F AY V
FIX	F IH K S
FIXED	F IH K S T
FIXING	F IH K S IH NG
FLAG	F L AE G
FLAT	F L AE T
FLATLINERS	F L AE T L AY N ER Z
FLAVOR	F L EY V ER
FLEAS	F L IY Z
FLEW	F L UW
FLEXIBILITY	F L EH K S AH B IH L AH T IY
FLEXIBLE	F L EH K S AH B AH L
FLIES	F L AY Z
FLIGHT	F L AY T
FLIP	F L IH P
FLOAT	F L OW T
FLOATING	F L OW T IH NG
FLOOD	F L AH D
FLOODING	F L AH D IH NG
FLOOR	F L AO R
FLOORS	F L AO R Z
FLORIDA	F L AO R AH D AH
FLORIDA(2)	F L AO R IH D AH
FLORIDA(3)	F L AA R AH D AH
FLORIDA(4)	F L AA R IH D AH
FLOUR	F L AW ER
FLOUR(2)	F L AW R
FLOW	F L OW
FLOWER	F L AW ER
FLOWERS	F L AW ER Z
FLY	F L AY
FLYING	F L AY IH NG
FOCUS	F OW K AH S
FOCUS(2)	F OW K IH S
FOCUSED	F OW K AH S T
FOCUSED(2)	F OW K IH S T
FOLK	F OW K
FOLKS	F OW K S
FOLLOW	F AA L OW
FOLLOWED	F AA L OW D
FOLLOWING	F AA L OW IH NG
FOLLOWS	F AA L OW Z
FOOD	F UW D
FOODS	F UW D Z
FOOL	F UW L
FOOT	F UH T
FOOTBALL	F UH T B AO L
FOR	F AO R
FOR(2)	F ER
FOR(3)	F R ER
FORCE	F AO R S
FORCED	F AO R S T
FORCES	F AO R S IH Z
FORCING	F AO R S IH NG
FORD	F AO R D
FORDS	F AO R D Z
FOREIGN	F AO R AH N
FOREIGN(2)	F AA R AH N
FOREST	F AO R AH S T
FOREST(2)	F AO R IH S T
FOREVER	F ER EH V ER
FORGET	F ER G EH T
FORGET(2)	F AO R G EH T
FORGOT	F ER G AA T
FORGOT(2)	F AO R G AA T
FORGOTTEN	F ER G AA T AH N
FORGOTTEN(2)	F AO R G AA T AH N
FORM	F AO R M
FORMAL	F AO R M AH L
FORMAT	F AO R M AE T
FORMED	F AO R M D
FORMER	F AO R M ER
FORMS	F AO R M Z
FORMULA	F AO R M Y AH L AH
FORT	F AO R T
FORTH	F AO R TH
FORTIES	F AO R T IY Z
FORTUNATE	F AO R CH AH N AH T
FORTUNATE(2)	F AO R CH UW N AH T
FORTUNATELY	F AO R CH AH N AH T L IY
FORTUNATELY(2)	F AO R CH UW N AH T L IY
FORTUNE	F AO R CH AH N
FORTUNE(2)	F AO R CH UW N
FORTY	F AO R T IY
FORWARD	F AO R W ER D
FOSTER	F AA S T ER
FOUGHT	F AO T
FOUND	F AW N D
FOUNDATION	F AW N D EY SH AH N
FOUR	F AO R
FOURTEEN	F AO R T IY N
FOURTEEN(2)	F AO R T IY N
FOURTH	F AO R TH
FOX	F AA K S
FRAME	F R EY M
FRANCE	F R AE N S
FRANCISCO	F R AE N S IH S K OW
FRANKLY	F R AE NG K L IY
FREAK	F R IY K
FREE	F R IY
FREEDOM	F R IY D AH M
FREEWAY	F R IY W EY
FREEZE	F R IY Z
FREEZES	F R IY Z IH Z
FREEZING	F R IY Z IH NG
FRENCH	F R EH N CH
FREON	F R IY AA N
FREQUENT	F R IY K W AH N T
FREQUENT(2)	F R IY K W EH N T
FREQUENTLY	F R IY K W AH N T L IY
FRESH	F R EH SH
FRESHMAN	F R EH SH M AH N
FRIDAY	F R AY D IY
FRIDAY(2)	F R AY D EY
FRIED	F R AY D
FRIED(2)	F R IY D
FRIEND	F R EH N D
FRIEND'S	F R EH N D Z
FRIEND'S(2)	F R EH N Z
FRIENDLY	F R EH N D L IY
FRIENDLY(2)	F R EH N L IY
FRIENDS	F R EH N D Z
FRIENDS(2)	F R EH N Z
FRIES	F R AY Z
FRIGHTENING	F R AY T AH N IH NG
FRIGHTENING(2)	F R AY T N IH NG
FROM	F R AH M
FROM(2)	F ER M
FRONT	F R AH N T
FROZEN	F R OW Z AH N
FRUIT	F R UW T
FRUSTRATED	F R AH S T R EY T AH D
FRUSTRATING	F R AH S T R EY T IH NG
FRY	F R AY
FUEL	F Y UW AH L
FUEL(2)	F Y UW L
FULL	F UH L
FULLY	F UH L IY
FUN	F AH N
FUNCTION	F AH NG K SH AH N
FUND	F AH N D
FUNDED	F AH N D AH D
FUNDED(2)	F AH N D IH D
FUNDING	F AH N D IH NG
FUNDS	F AH N D Z
FUNNIEST	F AH N IY AH S T
FUNNY	F AH N IY
FURNITURE	F ER N IH CH ER
FURTHER	F ER DH ER
FUTURE	F Y UW CH ER
G.	JH IY
GAIN	G EY N
GAINED	G EY N D
GALLON	G AE L AH N
GALVESTON	G AE L V AH S T AH N
GAME	G EY M
GAMES	G EY M Z
GANG	G AE NG
GANGS	G AE NG Z
GAP	G AE P
GARAGE	G ER AA ZH
GARBAGE	G AA R B IH JH
GARDEN	G AA R D AH N
GARDENING	G AA R D AH N IH NG
GARDENING(2)	G AA R D N IH NG
GARDENS	G AA R D AH N Z
GARLAND	G AA R L AH N D
GARLIC	G AA R L IH K
GARTH	G AA R TH
GARY	G EH R IY
GAS	G AE S
GASOLINE	G AE S AH L IY N
GATHER	G AE DH ER
GAVE	G EY V
GEAR	G IH R
GEARED	G IH R D
GEE	JH IY
GENERAL	JH EH N ER AH L
GENERAL(2)	JH EH N R AH L
GENERALLY	JH EH N ER AH L IY
GENERALLY(2)	JH EH N R AH L IY
GENERATE	JH EH N ER EY T
GENERATION	JH EH N ER EY SH AH N
GENERATIONS	JH EH N ER EY SH AH N Z
GENTLEMAN	JH EH N T AH L M AH N
GENTLEMAN(2)	JH EH N AH L M AH N
GEOGRAPHIC	JH IY AH G R AE F IH K
GEORGE	JH AO R JH
GEORGIA	JH AO R JH AH
GERMAN	JH ER M AH N
GERMANY	JH ER M AH N IY
GET	G EH T
GET(2)	G IH T
GETS	G EH T S
GETS(2)	G IH T S
GETTING	G EH T IH NG
GETTING(2)	G IH T IH NG
GHOST	G OW S T
GIANTS	JH AY AH N T S
GIFT	G IH F T
GIFTED	G IH F T AH D
GIFTED(2)	G IH F T IH D
GIFTS	G IH F T S
GIFTS(2)	G IH F S
GIRL	G ER L
GIRLFRIEND	G ER L F R EH N D
GIRLS	G ER L Z
GIVE	G IH V
GIVEN	G IH V AH N
GIVEN(2)	G IH V IH N
GIVES	G IH V Z
GIVING	G IH V IH NG
GLAD	G L AE D
GLASS	G L AE S
GLASSES	G L AE S AH Z
GLASSES(2)	G L AE S IH Z
GLOBAL	G L OW B AH L
GO	G OW
GOAL	G OW L
GOALS	G OW L Z
GOD	G AA D
GOD'S	G AA D Z
GOES	G OW Z
GOING	G OW IH NG
GOING(2)	G OW IH N
GOLD	G OW L D
GOLDEN	G OW L D AH N
GOLF	G AA L F
GOLF(2)	G AO L F
GOLFER	G AA L F ER
GOLLY	G AA L IY
GONE	G AO N
GOOD	G UH D
GOOD(2)	G IH D
GOODNESS	G UH D N AH S
GOODNESS(2)	G UH D N IH S
GOODS	G UH D Z
GORBACHEV	G AO R B AH CH EH V
GORBACHEV(2)	G AO R B AH CH AO F
GORGEOUS	G AO R JH AH S
GOSH	G AA SH
GOT	G AA T
GOTTEN	G AA T AH N
GOTTEN(2)	G AO T AH N
GOURMET	G UH R M EY
GOVERNMENT	G AH V ER M AH N T
GOVERNMENT(2)	G AH V ER N M AH N T
GOVERNMENT'S	G AH V ER M AH N T S
GOVERNMENT'S(2)	G AH V ER N M AH N T S
GOVERNMENTS	G AH V ER M AH N T S
GOVERNMENTS(2)	G AH V ER N M AH N T S
GOVERNOR	G AH V ER N ER
GRAB	G R AE B
GRACE	G R EY S
GRADE	G R EY D
GRADER	G R EY D ER
GRADES	G R EY D Z
GRADUALLY	G R AE JH UW AH L IY
GRADUALLY(2)	G R AE JH UW L IY
GRADUATE	G R AE JH AH W AH T
GRADUATE(2)	G R AE JH AH W EY T
GRADUATE(3)	G R AE JH UW W AH T
GRADUATE(4)	G R AE JH UW EY T
GRADUATED	G R AE JH UW EY T IH D
GRADUATED(2)	G R AE JH AH W EY T IH D
GRADUATES	G R AE JH AH W AH T S
GRADUATES(2)	G R AE JH AH W EY T S
GRADUATES(3)	G R AE JH UW W AH T S
GRADUATES(4)	G R AE JH UW EY T S
GRADUATING	G R AE JH AH W EY T IH NG
GRADUATING(2)	G R AE JH UW EY T IH NG
GRAND	G R AE N D
GRANDCHILDREN	G R AE N CH IH L D R AH N
GRANDCHILDREN(2)	G R AE N D CH IH L D R AH N
GRANDFATHER	G R AE N D F AA DH ER
GRANDFATHER(2)	G R AE N F AA DH ER
GRANDMA	G R AE M AA
GRANDMA(2)	G R AE N D M AA
GRANDMOTHER	G R AE N D M AH DH ER
GRANDMOTHER(2)	G R AE N M AH DH ER
GRANDMOTHER(3)	G R AE M AH DH ER
GRANDMOTHER'S	G R AE N D M AH DH ER Z
GRANDMOTHER'S(2)	G R AE M AH DH ER Z
GRANDMOTHER'S(3)	G R AE N M AH DH ER Z
GRANDPARENTS	G R AE N D P EH R AH N T S
GRANDPARENTS(2)	G R AE N P EH R AH N T S
GRANDPARENTS(3)	G R AE M P EH R AH N T S
GRANT	G R AE N T
GRANTED	G R AE N T AH D
GRANTED(2)	G R AE N T IH D
GRANTED(3)	G R AE N AH D
GRANTED(4)	G R AE N IH D
GRAPEVINE	G R EY P V AY N
GRAPHICS	G R AE F IH K S
GRASS	G R AE S
GRAY	G R EY
GREAT	G R EY T
GREATER	G R EY T ER
GREATEST	G R EY T AH S T
GREEK	G R IY K
GREEN	G R IY N
GREENS	G R IY N Z
GREW	G R UW
GRIEF	G R IY F
GRILL	G R IH L
GROCERIES	G R OW S ER IY Z
GROCERIES(2)	G R OW S R IY Z
GROCERY	G R OW S ER IY
GROCERY(2)	G R OW S R IY
GROSS	G R OW S
GROUND	G R AW N D
GROUNDS	G R AW N D Z
GROUNDS(2)	G R AW N Z
GROUP	G R UW P
GROUPS	G R UW P S
GROW	G R OW
GROWING	G R OW IH NG
GROWN	G R OW N
GROWS	G R OW Z
GROWTH	G R OW TH
GUARANTEE	G EH R AH N T IY
GUARANTEED	G EH R AH N T IY D
GUARD	G AA R D
GUESS	G EH S
GUESTS	G EH S T S
GUESTS(2)	G EH S S
GUESTS(3)	G EH S
GUIDE	G AY D
GUIDELINES	G AY D L AY N Z
GUILT	G IH L T
GUILTY	G IH L T IY
GUITAR	G IH T AA R
GULF	G AH L F
GUN	G AH N
GUNS	G AH N Z
GUY	G AY
GUY'S	G AY Z
GUYS	G AY Z
GYM	JH IH M
H.	EY CH
HABIT	HH AE B AH T
HABITS	HH AE B AH T S
HAD	HH AE D
HADN'T	HH AE D AH N T
HADN'T(2)	HH AE D AH N
HAIL	HH EY L
HAIR	HH EH R
HALF	HH AE F
HALFWAY	HH AE F W EY
HALL	HH AO L
HAM	HH AE M
HAMBURGER	HH AE M B ER G ER
HAMBURGERS	HH AE M B ER G ER Z
HAMPSHIRE	HH AE M P SH ER
HAMPSHIRE(2)	HH AE M SH ER
HAMPSHIRE(3)	HH AE M P SH AY ER
HAMPSHIRE(4)	HH AE M SH AY ER
HAND	HH AE N D
HANDGUN	HH AE N D G AH N
HANDGUNS	HH AE N D G AH N Z
HANDICAPPED	HH AE N D IY K AE P T
HANDLE	HH AE N D AH L
HANDLED	HH AE N D AH L D
HANDLES	HH AE N D AH L Z
HANDLING	HH AE N D L IH NG
HANDLING(2)	HH AE N D AH L IH NG
HANDS	HH AE N D Z
HANDS(2)	HH AE N Z
HANDY	HH AE N D IY
HANG	HH AE NG
HANGING	HH AE NG IH NG
HANGING(2)	HH AE NG G IH NG
HAPPEN	HH AE P AH N
HAPPENED	HH AE P AH N D
HAPPENING	HH AE P AH N IH NG
HAPPENING(2)	HH AE P N IH NG
HAPPENS	HH AE P AH N Z
HAPPY	HH AE P IY
HARD	HH AA R D
HARDER	HH AA R D ER
HARDEST	HH AA R D AH S T
HARDLY	HH AA R D L IY
HARDWARE	HH AA R D W EH R
HARVARD	HH AA R V ER D
HAS	HH AE Z
HAS(2)	HH AH Z
HASN'T	HH AE Z AH N T
HASSLE	HH AE S AH L
HAT	HH AE T
HATE	HH EY T
HATED	HH EY T AH D
HATED(2)	HH EY T IH D
HATES	HH EY T S
HAUL	HH AO L
HAVE	HH AE V
HAVEN'T	HH AE V AH N T
HAVEN'T(2)	HH AE V AH N
HAVING	HH AE V IH NG
HAWAII	HH AH W AY IY
HE	HH IY
HE'D	HH IY D
HE'LL	HH IY L
HE'S	HH IY Z
HEAD	HH EH D
HEADED	HH EH D AH D
HEADED(2)	HH EH D IH D
HEADING	HH EH D IH NG
HEADLINE	HH EH D L AY N
HEADLINES	HH EH D L AY N Z
HEADS	HH EH D Z
HEALTH	HH EH L TH
HEALTHY	HH EH L TH IY
HEAR	HH IH R
HEARD	HH ER D
HEARING	HH IH R IH NG
HEART	HH AA R T
HEAT	HH IY T
HEATED	HH IY T AH D
HEATED(2)	HH IY T IH D
HEATER	HH IY T ER
HEATING	HH IY T IH NG
HEAVEN	HH EH V AH N
HEAVIER	HH EH V IY ER
HEAVILY	HH EH V AH L IY
HEAVY	HH EH V IY
HECK	HH EH K
HEELS	HH IY L Z
HEINOUS	HH EY N AH S
HELD	HH EH L D
HELL	HH EH L
HELLO	HH AH L OW
HELLO(2)	HH EH L OW
HELP	HH EH L P
HELPED	HH EH L P T
HELPFUL	HH EH L P F AH L
HELPING	HH EH L P IH NG
HELPS	HH EH L P S
HER	HH ER
HER(2)	HH ER
HERALD	HH EH R AH L D
HERE	HH IH R
HERE'S	HH IH R Z
HERITAGE	HH EH R AH T AH JH
HERITAGE(2)	HH EH R IH T IH JH
HERS	HH ER Z
HERS(2)	HH ER Z
HERSELF	HH ER S EH L F
HEY	HH EY
HI	HH AY
HIDDEN	HH IH D AH N
HIDE	HH AY D
HIGH	HH AY
HIGHER	HH AY ER
HIGHEST	HH AY AH S T
HIGHLY	HH AY L IY
HIGHWAY	HH AY W EY
HIGHWAYS	HH AY W EY Z
HIKE	HH AY K
HIKING	HH AY K IH NG
HILARIOUS	HH IH L EH R IY AH S
HILL	HH IH L
HILLS	HH IH L Z
HIM	HH IH M
HIM(2)	IH M
HIMSELF	HH IH M S EH L F
HIP	HH IH P
HIRE	HH AY ER
HIRE(2)	HH AY R
HIRED	HH AY ER D
HIRING	HH AY R IH NG
HIS	HH IH Z
HIS(2)	HH IH Z
HISPANIC	HH IH S P AE N IH K
HISTORICAL	HH IH S T AO R IH K AH L
HISTORICALLY	HH IH S T AO R IH K AH L IY
HISTORICALLY(2)	HH IH S T AO R IH K L IY
HISTORY	HH IH S T ER IY
HISTORY(2)	HH IH S T R IY
HIT	HH IH T
HITS	HH IH T S
HITTING	HH IH T IH NG
HM	HH M
HO	HH OW
HOBBIES	HH AA B IY Z
HOBBY	HH AA B IY
HOLD	HH OW L D
HOLDING	HH OW L D IH NG
HOLDS	HH OW L D Z
HOLE	HH OW L
HOLES	HH OW L Z
HOLIDAY	HH AA L AH D EY
HOLIDAY(2)	HH AA L IH D EY
HOLIDAYS	HH AA L AH D EY Z
HOLY	HH OW L IY
HOME	HH OW M
HOMELESS	HH OW M L AH S
HOMES	HH OW M Z
HOMEWORK	HH OW M W ER K
HONDA	HH AO N D AH
HONEST	AA N AH S T
HONESTLY	AA N AH S T L IY
HONESTLY(2)	AA N AH S L IY
HONEY	HH AH N IY
HONOR	AA N ER
HOOD	HH UH D
HOOK	HH UH K
HOOKED	HH UH K T
HOPE	HH OW P
HOPEFULLY	HH OW P F AH L IY
HOPING	HH OW P IH NG
HORRENDOUS	HH AO R EH N D AH S
HORRIBLE	HH AO R AH B AH L
HORROR	HH AO R ER
HORSE	HH AO R S
HORSES	HH AO R S AH Z
HORSES(2)	HH AO R S IH Z
HOSE	HH OW Z
HOSPITAL	HH AA S P IH T AH L
HOSPITALS	HH AA S P IH T AH L Z
HOT	HH AA T
HOTEL	HH OW T EH L
HOTELS	HH OW T EH L Z
HOUR	AW ER
HOUR(2)	AW R
HOURS	AW ER Z
HOURS(2)	AW R Z
HOUSE	HH AW S
HOUSEHOLD	HH AW S HH OW L D
HOUSEKEEPING	HH AW S K IY P IH NG
HOUSES	HH AW S AH Z
HOUSES(2)	HH AW S IH Z
HOUSEWIFE	HH AW S W AY F
HOUSING	HH AW Z IH NG
HOUSTON	HH Y UW S T AH N
HOW	HH AW
HOW'D	HH AW D
HOW'S	HH AW Z
HOWEVER	HH AW EH V ER
HUGE	HH Y UW JH
HUGE(2)	Y UW JH
HUMAN	HH Y UW M AH N
HUMAN(2)	Y UW M AH N
HUMANE	HH Y UW M EY N
HUMID	HH Y UW M AH D
HUMID(2)	HH Y UW M IH D
HUMID(3)	Y UW M AH D
HUMID(4)	Y UW M IH D
HUMIDITY	HH Y UW M IH D AH T IY
HUMOR	HH Y UW M ER
HUNDRED	HH AH N D R AH D
HUNDRED(2)	HH AH N D R IH D
HUNDRED(3)	HH AH N ER D
HUNDRED(4)	HH AH N D ER D
HUNDREDS	HH AH N D R AH D Z
HUNDREDS(2)	HH AH N D ER D Z
HUNDREDS(3)	HH AH N ER D Z
HUNG	HH AH NG
HUNGRY	HH AH NG G R IY
HUNT	HH AH N T
HUNTER	HH AH N T ER
HUNTING	HH AH N T IH NG
HURRY	HH ER IY
HURT	HH ER T
HURTING	HH ER T IH NG
HURTS	HH ER T S
HUSBAND	HH AH Z B AH N D
HUSBAND'S	HH AH Z B AH N D Z
HUSBANDS	HH AH Z B AH N D Z
HUSSEIN	HH UW S EY N
HYSTERICAL	HH IH S T EH R IH K AH L
I	AY
I'D	AY D
I'LL	AY L
I'M	AY M
I'S	AY Z
I'VE	AY V
I.	AY
ICE	AY S
IDAHO	AY D AH HH OW
IDEA	AY D IY AH
IDEAL	AY D IY L
IDEAS	AY D IY AH Z
IDENTIFY	AY D EH N T AH F AY
IDENTIFY(2)	AY D EH N AH F AY
IF	IH F
IF(2)	IH F
IGNORE	IH G N AO R
ILL	IH L
ILLEGAL	IH L IY G AH L
ILLINOIS	IH L AH N OY
ILLINOIS(2)	IH L AH N OY Z
IMAGE	IH M AH JH
IMAGE(2)	IH M IH JH
IMAGINATION	IH M AE JH AH N EY SH AH N
IMAGINE	IH M AE JH AH N
IMMEDIATE	IH M IY D IY AH T
IMMEDIATELY	IH M IY D IY AH T L IY
IMMIGRANTS	IH M AH G R AH N T S
IMMIGRATION	IH M AH G R EY SH AH N
IMPACT	IH M P AE K T
IMPACT(2)	IH M P AE K T
IMPORTANCE	IH M P AO R T AH N S
IMPORTANT	IH M P AO R T AH N T
IMPOSSIBLE	IH M P AA S AH B AH L
IMPRESSED	IH M P R EH S T
IMPRESSION	IH M P R EH SH AH N
IMPRESSIVE	IH M P R EH S IH V
IMPROVE	IH M P R UW V
IMPROVED	IH M P R UW V D
IMPROVEMENT	IH M P R UW V M AH N T
IMPROVEMENTS	IH M P R UW V M AH N T S
IN	IH N
IN(2)	IH N
INCENTIVE	IH N S EH N T IH V
INCENTIVE(2)	IH N S EH N IH V
INCH	IH N CH
INCHES	IH N CH AH Z
INCHES(2)	IH N CH IH Z
INCLINED	IH N K L AY N D
INCLUDE	IH N K L UW D
INCLUDED	IH N K L UW D AH D
INCLUDED(2)	IH N K L UW D IH D
INCLUDING	IH N K L UW D IH NG
INCOME	IH N K AH M
INCONVENIENT	IH N K AH N V IY N Y AH N T
INCREASE	IH N K R IY S
INCREASE(2)	IH N K R IY S
INCREASED	IH N K R IY S T
INCREASED(2)	IH N K R IY S T
INCREASES	IH N K R IY S AH Z
INCREASES(2)	IH N K R IY S IH Z
INCREASES(3)	IH N K R IY S AH Z
INCREASING	IH N K R IY S IH NG
INCREDIBLE	IH N K R EH D AH B AH L
INCREDIBLY	IH N K R EH D AH B L IY
INDEED	IH N D IY D
INDEPENDENCE	IH N D IH P EH N D AH N S
INDEPENDENT	IH N D IH P EH N D AH N T
INDIAN	IH N D IY AH N
INDIANA	IH N D IY AE N AH
INDIANAPOLIS	IH N D IY AH N AE P AH L IH S
INDIANS	IH N D IY AH N Z
INDIVIDUAL	IH N D AH V IH JH AH W AH L
INDIVIDUALLY	IH N D IH V IH JH UW AH L IY
INDIVIDUALLY(2)	IH N D IH V IH JH AH L IY
INDIVIDUALS	IH N D AH V IH JH AH W AH L Z
INDOOR	IH N D AO R
INDOORS	IH N D AO R Z
INDUSTRIAL	IH N D AH S T R IY AH L
INDUSTRIES	IH N D AH S T R IY Z
INDUSTRY	IH N D AH S T R IY
INEXPENSIVE	IH N IH K S P EH N S IH V
INFANT	IH N F AH N T
INFLUENCE	IH N F L UW AH N S
INFORMATION	IH N F ER M EY SH AH N
INFORMATION(2)	IH N F AO R M EY SH AH N
INFORMED	IH N F AO R M D
INITIAL	IH N IH SH AH L
INITIALLY	IH N IH SH AH L IY
INJECTION	IH N JH EH K SH AH N
INJURED	IH N JH ER D
INJURIES	IH N JH ER IY Z
INJURY	IH N JH ER IY
INNER	IH N ER
INNOCENT	IH N AH S AH N T
INPUT	IH N P UH T
INS	IH N Z
INS(2)	AY EH N EH S
INSANE	IH N S EY N
INSIDE	IH N S AY D
INSIDE(2)	IH N S AY D
INSPECTION	IH N S P EH K SH AH N
INSTANCE	IH N S T AH N S
INSTANCES	IH N S T AH N S AH Z
INSTANCES(2)	IH N S T AH N S IH Z
INSTANT	IH N S T AH N T
INSTEAD	IH N S T EH D
INSTITUTE	IH N S T AH T UW T
INSTITUTION	IH N S T IH T UW SH AH N
INSTRUCTOR	IH N S T R AH K T ER
INSTRUMENT	IH N S T R AH M AH N T
INSTRUMENTS	IH N S T R AH M AH N T S
INSURANCE	IH N SH UH R AH N S
INTELLIGENCE	IH N T EH L AH JH AH N S
INTELLIGENT	IH N T EH L AH JH AH N T
INTEND	IH N T EH N D
INTENDED	IH N T EH N D AH D
INTENDED(2)	IH N T EH N D IH D
INTENSE	IH N T EH N S
INTENT	IH N T EH N T
INTENTIONALLY	IH N T EH N SH AH N AH L IY
INTERACT	IH N T ER AE K T
INTERACT(2)	IH N ER AE K T
INTERACTION	IH N T ER AE K SH AH N
INTERACTION(2)	IH N ER AE K SH AH N
INTEREST	IH N T R AH S T
INTEREST(2)	IH N T R IH S T
INTEREST(3)	IH N T ER AH S T
INTEREST(4)	IH N T ER IH S T
INTERESTED	IH N T R AH S T AH D
INTERESTED(2)	IH N T R IH S T IH D
INTERESTED(3)	IH N T ER AH S T AH D
INTERESTED(4)	IH N T ER IH S T IH D
INTERESTING	IH N T R AH S T IH NG
INTERESTING(2)	IH N T R IH S T IH NG
INTERESTING(3)	IH N T ER AH S T IH NG
INTERESTING(4)	IH N T ER IH S T IH NG
INTERESTINGLY	IH N T ER EH S T IH NG L IY
INTERESTS	IH N T R AH S T S
INTERESTS(2)	IH N T R IH S T S
INTERESTS(3)	IH N T R IH S S
INTERESTS(4)	IH N T ER AH S T S
INTERESTS(5)	IH N T ER IH S T S
INTERESTS(6)	IH N T ER IH S S
INTERIOR	IH N T IH R IY ER
INTERNAL	IH N T ER N AH L
INTERNATIONAL	IH N T ER N AE SH AH N AH L
INTERNATIONAL(2)	IH N ER N AE SH AH N AH L
INTERSTATE	IH N T ER S T EY T
INTERSTATE(2)	IH N ER S T EY T
INTERVIEW	IH N T ER V Y UW
INTERVIEW(2)	IH N ER V Y UW
INTERVIEWED	IH N T ER V Y UW D
INTERVIEWED(2)	IH N ER V Y UW D
INTO	IH N T UW
INTO(2)	IH N T UW
INTO(3)	IH N T AH
INTRODUCED	IH N T R AH D UW S T
INTRODUCED(2)	IH N T R OW D UW S T
INVADE	IH N V EY D
INVADED	IH N V EY D AH D
INVADED(2)	IH N V EY D IH D
INVADING	IH N V EY D IH NG
INVASION	IH N V EY ZH AH N
INVEST	IH N V EH S T
INVESTED	IH N V EH S T AH D
INVESTED(2)	IH N V EH S T IH D
INVESTMENT	IH N V EH S T M AH N T
INVESTMENT(2)	IH N V EH S M AH N T
INVESTMENTS	IH N V EH S T M AH N T S
INVESTMENTS(2)	IH N V EH S M AH N T S
INVOLVE	IH N V AA L V
INVOLVED	IH N V AA L V D
INVOLVEMENT	IH N V AA L V M AH N T
INVOLVES	IH N V AA L V Z
IOWA	AY AH W AH
IOWA(2)	AY OW AH
IRAN	IH R AA N
IRAN(2)	AY R AE N
IRAQ	IH R AA K
IRAQ(2)	IY R AA K
IRAQ(3)	AY R AA K
IRELAND	AY ER L AH N D
IRELAND(2)	AY R L AH N D
IRON	AY ER N
IRONIC	AY R AA N IH K
IS	IH Z
IS(2)	IH Z
ISLAND	AY L AH N D
ISLANDS	AY L AH N D Z
ISN'T	IH Z AH N T
ISN'T(2)	IH Z AH N T
ISN'T(3)	IH Z AH N
ISOLATED	AY S AH L EY T AH D
ISOLATED(2)	AY S AH L EY T IH D
ISRAEL	IH Z R IY AH L
ISRAEL(2)	IH Z R EY L
ISRAELIS	IH Z R EY L IY Z
ISSUE	IH SH UW
ISSUES	IH SH UW Z
IT	IH T
IT(2)	IH T
IT'D	IH T AH D
IT'LL	IH T AH L
IT'LL(2)	IH T L
IT'S	IH T S
IT'S(2)	IH T S
ITALIAN	IH T AE L Y AH N
ITALY	IH T AH L IY
ITEM	AY T AH M
ITEMS	AY T AH M Z
ITS	IH T S
ITS(2)	IH T S
ITSELF	IH T S EH L F
J.	JH EY
JACK	JH AE K
JACKET	JH AE K AH T
JACKET(2)	JH AE K IH T
JACKETS	JH AE K IH T S
JAIL	JH EY L
JAILS	JH EY L Z
JAMES	JH EY M Z
JANUARY	JH AE N Y UW EH R IY
JAPAN	JH AH P AE N
JAPANESE	JH AE P AH N IY Z
JAZZ	JH AE Z
JEAN	JH IY N
JEANS	JH IY N Z
JEEZ	JH IY Z
JERRY	JH EH R IY
JERSEY	JH ER Z IY
JEWELRY	JH UW AH L R IY
JEWELRY(2)	JH UW L R IY
JEWELRY(3)	JH UW L ER IY
JEWISH	JH UW IH SH
JIM	JH IH M
JIMMY	JH IH M IY
JOB	JH AA B
JOB(2)	JH OW B
JOBS	JH AA B Z
JOE	JH OW
JOG	JH AA G
JOGGING	JH AA G IH NG
JOGGING(2)	JH AO G IH NG
JOHN	JH AA N
JOHNNY	JH AA N IY
JOHNSON	JH AA N S AH N
JOIN	JH OY N
JOINED	JH OY N D
JOINT	JH OY N T
JOINTS	JH OY N T S
JOKE	JH OW K
JONES	JH OW N Z
JORDAN	JH AO R D AH N
JOURNAL	JH ER N AH L
JOY	JH OY
JUDGE	JH AH JH
JUDGES	JH AH JH IH Z
JUDGMENT	JH AH JH M AH N T
JUDICIAL	JH UW D IH SH AH L
JUGS	JH AH G Z
JUICE	JH UW S
JULIA	JH UW L Y AH
JULY	JH UW L AY
JULY(2)	JH AH L AY
JUMP	JH AH M P
JUMPED	JH AH M P T
JUMPING	JH AH M P IH NG
JUNE	JH UW N
JUNIOR	JH UW N Y ER
JUNK	JH AH NG K
JURIES	JH UH R IY Z
JUROR	JH UH R ER
JURORS	JH UH R ER Z
JURY	JH UH R IY
JUST	JH AH S T
JUST(2)	JH IH S T
JUSTICE	JH AH S T AH S
JUSTICE(2)	JH AH S T IH S
JUSTIFY	JH AH S T AH F AY
K.	K EY
KANSAS	K AE N Z AH S
KEEP	K IY P
KEEPING	K IY P IH NG
KEEPS	K IY P S
KENNEDY	K EH N AH D IY
KENTUCKY	K AH N T AH K IY
KEPT	K EH P T
KEPT(2)	K AE P T
KEVIN	K EH V IH N
KEY	K IY
KEYS	K IY Z
KICK	K IH K
KICKED	K IH K T
KID	K IH D
KID'S	K IH D Z
KIDDING	K IH D IH NG
KIDS	K IH D Z
KIDS'	K IH D Z
KILL	K IH L
KILLED	K IH L D
KILLER	K IH L ER
KILLING	K IH L IH NG
KILLS	K IH L Z
KILOMETERS	K AH L AA M AH T ER Z
KILOMETERS(2)	K IH L AH M IY T ER Z
KIND	K AY N D
KINDERGARTEN	K IH N D ER G AA R T AH N
KINDS	K AY N D Z
KINDS(2)	K AY N Z
KING	K IH NG
KITCHEN	K IH CH AH N
KITTENS	K IH T AH N Z
KITTY	K IH T IY
KNEE	N IY
KNEES	N IY Z
KNEW	N UW
KNEW(2)	N Y UW
KNIFE	N AY F
KNIT	N IH T
KNITTING	N IH T IH NG
KNOCK	N AA K
KNOCKED	N AA K T
KNOW	N OW
KNOWING	N OW IH NG
KNOWLEDGE	N AA L AH JH
KNOWLEDGE(2)	N AA L IH JH
KNOWLEDGEABLE	N AA L AH JH AH B AH L
KNOWN	N OW N
KNOWS	N OW Z
KURDS	K ER D Z
KUWAIT	K UW W EY T
L.	EH L
LAB	L AE B
LABOR	L EY B ER
LABORATORY	L AE B R AH T AO R IY
LABS	L AE B Z
LACK	L AE K
LADIES	L EY D IY Z
LADY	L EY D IY
LAID	L EY D
LAKE	L EY K
LAKERS	L EY K ER Z
LAKES	L EY K S
LAMBS	L AE M Z
LAND	L AE N D
LANDFILL	L AE N D F IH L
LANDFILLS	L AE N D F IH L Z
LANDING	L AE N D IH NG
LANDRY	L AE N D R IY
LANDSCAPING	L AE N D S K EY P IH NG
LANDSCAPING(2)	L AE N S K EY P IH NG
LANGUAGE	L AE NG G W AH JH
LANGUAGE(2)	L AE NG G W IH JH
LANGUAGES	L AE NG G W AH JH AH Z
LANGUAGES(2)	L AE NG G W IH JH IH Z
LAP	L AE P
LARGE	L AA R JH
LARGER	L AA R JH ER
LARGEST	L AA R JH AH S T
LARRY	L EH R IY
LAS	L AA S
LAS(2)	EH L EY EH S
LASAGNA	L AA S AA N Y AH
LASAGNA(2)	L AH Z AA N Y AH
LASER	L EY Z ER
LAST	L AE S T
LAST(2)	L AO S T
LAST(3)	L AE S
LASTED	L AE S T AH D
LASTED(2)	L AE S T IH D
LASTS	L AE S T S
LATE	L EY T
LATELY	L EY T L IY
LATER	L EY T ER
LATEST	L EY T AH S T
LATEX	L EY T EH K S
LATIN	L AE T AH N
LAUGH	L AE F
LAUGHED	L AE F T
LAUGHING	L AE F IH NG
LAUNDRY	L AO N D R IY
LAW	L AO
LAW(2)	L AA
LAW'S	L AO Z
LAWN	L AO N
LAWNS	L AO N Z
LAWS	L AO Z
LAWYER	L AO Y ER
LAWYER(2)	L OY ER
LAWYERS	L AO Y ER Z
LAWYERS(2)	L OY ER Z
LAY	L EY
LAYER	L EY ER
LAYING	L EY IH NG
LAYOFFS	L EY AO F S
LAZY	L EY Z IY
LEAD	L EH D
LEAD(2)	L IY D
LEADER	L IY D ER
LEADERS	L IY D ER Z
LEADERSHIP	L IY D ER SH IH P
LEADING	L IY D IH NG
LEADS	L IY D Z
LEAF	L IY F
LEAGUE	L IY G
LEAK	L IY K
LEAN	L IY N
LEANING	L IY N IH NG
LEAP	L IY P
LEARN	L ER N
LEARNED	L ER N D
LEARNED(2)	L ER N IH D
LEARNING	L ER N IH NG
LEASE	L IY S
LEAST	L IY S T
LEATHER	L EH DH ER
LEAVE	L IY V
LEAVES	L IY V Z
LEAVING	L IY V IH NG
LED	L EH D
LEE	L IY
LEFT	L EH F T
LEG	L EH G
LEGAL	L IY G AH L
LEGALLY	L IY G AH L IY
LEGISLATION	L EH JH AH S L EY SH AH N
LEGISLATURE	L EH JH AH S L EY CH ER
LEGITIMATE	L AH JH IH T AH M AH T
LEGS	L EH G Z
LEHRER	L EH R ER
LEMON	L EH M AH N
LENGTH	L EH NG K TH
LENGTH(2)	L EH NG TH
LENIENT	L IY N IY AH N T
LENIENT(2)	L IY N Y AH N T
LESS	L EH S
LESSER	L EH S ER
LESSON	L EH S AH N
LESSONS	L EH S AH N Z
LET	L EH T
LET'S	L EH T S
LETHAL	L IY TH AH L
LETS	L EH T S
LETTER	L EH T ER
LETTERS	L EH T ER Z
LETTING	L EH T IH NG
LEVEL	L EH V AH L
LEVELS	L EH V AH L Z
LEWISVILLE	L UW IH S V IH L
LIABLE	L AY AH B AH L
LIBERAL	L IH B ER AH L
LIBERAL(2)	L IH B R AH L
LIBERTY	L IH B ER T IY
LIBRARY	L AY B R EH R IY
LICENSE	L AY S AH N S
LIE	L AY
LIFE	L AY F
LIFESTYLE	L AY F S T AY L
LIFETIME	L AY F T AY M
LIFT	L IH F T
LIFTING	L IH F T IH NG
LIGHT	L AY T
LIGHTER	L AY T ER
LIGHTS	L AY T S
LIKE	L AY K
LIKED	L AY K T
LIKELY	L AY K L IY
LIKES	L AY K S
LIKING	L AY K IH NG
LIMIT	L IH M AH T
LIMITED	L IH M AH T AH D
LIMITED(2)	L IH M IH T IH D
LIMITS	L IH M AH T S
LIMITS(2)	L IH M IH T S
LINCOLN	L IH NG K AH N
LINE	L AY N
LINES	L AY N Z
LIQUID	L IH K W AH D
LIQUID(2)	L IH K W IH D
LIST	L IH S T
LISTEN	L IH S AH N
LISTENED	L IH S AH N D
LISTENING	L IH S AH N IH NG
LISTENING(2)	L IH S N IH NG
LISTS	L IH S T S
LISTS(2)	L IH S S
LISTS(3)	L IH S
LITER	L IY T ER
LITERALLY	L IH T ER AH L IY
LITERALLY(2)	L IH T R AH L IY
LITERATURE	L IH T ER AH CH ER
LITTER	L IH T ER
LITTLE	L IH T AH L
LIVE	L AY V
LIVE(2)	L IH V
LIVED	L AY V D
LIVED(2)	L IH V D
LIVES	L IH V Z
LIVES(2)	L AY V Z
LIVING	L IH V IH NG
LOAD	L OW D
LOADED	L OW D AH D
LOADED(2)	L OW D IH D
LOAN	L OW N
LOANS	L OW N Z
LOBBY	L AA B IY
LOBSTER	L AA B S T ER
LOCAL	L OW K AH L
LOCALLY	L OW K AH L IY
LOCATED	L OW K EY T AH D
LOCATED(2)	L OW K EY D
LOCATION	L OW K EY SH AH N
LOCK	L AA K
LOCKED	L AA K T
LOG	L AO G
LOGIC	L AA JH IH K
LOGICAL	L AA JH IH K AH L
LONDON	L AH N D AH N
LONG	L AO NG
LONGER	L AO NG G ER
LONGEST	L AO NG G AH S T
LONGEST(2)	L AO NG G IH S T
LOOK	L UH K
LOOKED	L UH K T
LOOKING	L UH K IH NG
LOOKS	L UH K S
LOOSE	L UW S
LORD	L AO R D
LOS	L OW S
LOS(2)	L AO S
LOSE	L UW Z
LOSES	L UW Z AH Z
LOSES(2)	L UW Z IH Z
LOSING	L UW Z IH NG
LOSS	L AO S
LOST	L AO S T
LOT	L AA T
LOT(2)	L AO T
LOTS	L AA T S
LOTTERY	L AA T ER IY
LOTUS	L OW T AH S
LOUD	L AW D
LOUIS	L UW IH S
LOUIS(2)	L UW IY
LOUISIANA	L UW IY Z IY AE N AH
LOUISVILLE	L UW IY V IH L
LOUSY	L AW Z IY
LOVE	L AH V
LOVED	L AH V D
LOVELY	L AH V L IY
LOVES	L AH V Z
LOVING	L AH V IH NG
LOW	L OW
LOWER	L OW ER
LOWEST	L OW AH S T
LUBBOCK	L AH B AH K
LUCK	L AH K
LUCKILY	L AH K AH L IY
LUCKY	L AH K IY
LUNCH	L AH N CH
LUXURY	L AH G ZH ER IY
LYING	L AY IH NG
M.	EH M
MA'AM	M AE M
MAC	M AE K
MACHINE	M AH SH IY N
MACHINERY	M AH SH IY N ER IY
MACHINERY(2)	M AH SH IY N R IY
MACHINES	M AH SH IY N Z
MAD	M AE D
MADE	M EY D
MAGAZINE	M AE G AH Z IY N
MAGAZINES	M AE G AH Z IY N Z
MAGIC	M AE JH IH K
MAIL	M EY L
MAIN	M EY N
MAINE	M EY N
MAINFRAME	M EY N F R EY M
MAINLY	M EY N L IY
MAINTAIN	M EY N T EY N
MAINTENANCE	M EY N T AH N AH N S
MAINTENANCE(2)	M EY N T N AH N S
MAJOR	M EY JH ER
MAJORITY	M AH JH AO R AH T IY
MAJORS	M EY JH ER Z
MAKE	M EY K
MAKERS	M EY K ER Z
MAKES	M EY K S
MAKEUP	M EY K AH P
MAKING	M EY K IH NG
MALAYSIA	M AH L EY ZH AH
MALE	M EY L
MALL	M AO L
MAN	M AE N
MAN'S	M AE N Z
MANAGE	M AE N AH JH
MANAGE(2)	M AE N IH JH
MANAGED	M AE N AH JH D
MANAGED(2)	M AE N IH JH D
MANAGEMENT	M AE N AH JH M AH N T
MANAGEMENT(2)	M AE N IH JH M AH N T
MANAGER	M AE N AH JH ER
MANAGER(2)	M AE N IH JH ER
MANAGERS	M AE N AH JH ER Z
MANAGERS(2)	M AE N IH JH ER Z
MANDATORY	M AE N D AH T AO R IY
MANNER	M AE N ER
MANUFACTURERS	M AE N Y AH F AE K CH ER ER Z
MANUFACTURING	M AE N Y AH F AE K CH ER IH NG
MANY	M EH N IY
MAP	M AE P
MARCH	M AA R CH
MARCHING	M AA R CH IH NG
MARIJUANA	M EH R AH W AA N AH
MARK	M AA R K
MARKED	M AA R K T
MARKET	M AA R K AH T
MARKET(2)	M AA R K IH T
MARKETING	M AA R K AH T IH NG
MARKS	M AA R K S
MARRIAGE	M EH R IH JH
MARRIED	M EH R IY D
MART	M AA R T
MARVELOUS	M AA R V AH L AH S
MARY	M EH R IY
MARYLAND	M EH R AH L AH N D
MASS	M AE S
MASSACHUSETTS	M AE S AH CH UW S AH T S
MASSIVE	M AE S IH V
MASTER	M AE S T ER
MASTER'S	M AE S T ER Z
MASTERCARD	M AE S T ER K AA R D
MASTERS	M AE S T ER Z
MATCH	M AE CH
MATERIAL	M AH T IH R IY AH L
MATERIALS	M AH T IH R IY AH L Z
MATH	M AE TH
MATTER	M AE T ER
MATTERS	M AE T ER Z
MATURE	M AH CH UH R
MATURE(2)	M AH T Y UH R
MAVERICKS	M AE V ER IH K S
MAVERICKS(2)	M AE V R IH K S
MAX	M AE K S
MAXIMUM	M AE K S AH M AH M
MAY	M EY
MAYBE	M EY B IY
MAYOR	M EY ER
MAZDA	M AA Z D AH
MAZDA(2)	M AE Z D AH
MCDONALD'S	M AH K D AA N AH L D Z
MCDONALDS	M AH K D AA N AH L D Z
MCKINNEY	M AH K IH N IY
ME	M IY
MEAL	M IY L
MEALS	M IY L Z
MEAN	M IY N
MEANING	M IY N IH NG
MEANS	M IY N Z
MEANT	M EH N T
MEANTIME	M IY N T AY M
MEASURE	M EH ZH ER
MEAT	M IY T
MECHANIC	M AH K AE N IH K
MECHANIC(2)	M IH K AE N IH K
MECHANICAL	M AH K AE N IH K AH L
MECHANICS	M AH K AE N IH K S
MEDIA	M IY D IY AH
MEDICAID	M EH D AH K EY D
MEDICAL	M EH D AH K AH L
MEDICAL(2)	M EH D IH K AH L
MEDICARE	M EH D AH K EH R
MEDICATION	M EH D AH K EY SH AH N
MEDICINE	M EH D AH S AH N
MEDIUM	M IY D IY AH M
MEET	M IY T
MEETING	M IY T IH NG
MEETINGS	M IY T IH NG Z
MELT	M EH L T
MELTED	M EH L T AH D
MELTED(2)	M EH L T IH D
MEMBER	M EH M B ER
MEMBERS	M EH M B ER Z
MEMBERSHIP	M EH M B ER SH IH P
MEMORIAL	M AH M AO R IY AH L
MEMORIES	M EH M ER IY Z
MEMORY	M EH M ER IY
MEMPHIS	M EH M F AH S
MEMPHIS(2)	M EH M F IH S
MEMPHIS(3)	M EH M P F AH S
MEMPHIS(4)	M EH M P F IH S
MEN	M EH N
MEN'S	M EH N Z
MENTAL	M EH N T AH L
MENTALITY	M EH N T AE L AH T IY
MENTALITY(2)	M EH N T AE L IH T IY
MENTALLY	M EH N T AH L IY
MENTALLY(2)	M EH N AH L IY
MENTION	M EH N SH AH N
MENTIONED	M EH N SH AH N D
MENU	M EH N Y UW
MERCEDES	M ER S EY D IY Z
MERCHANDISE	M ER CH AH N D AY Z
MERCURY	M ER K Y ER IY
MERIT	M EH R AH T
MESQUITE	M EH S K IY T
MESS	M EH S
MESSAGE	M EH S AH JH
MESSAGE(2)	M EH S IH JH
MESSED	M EH S T
MESSING	M EH S IH NG
MET	M EH T
METAL	M EH T AH L
METHOD	M EH TH AH D
METHODIST	M EH TH AH D AH S T
METHODIST(2)	M EH TH AH D IH S T
METRIC	M EH T R IH K
METROPLEX	M EH T R OW P L EH K S
METROPOLITAN	M EH T R AH P AA L AH T AH N
MEX	M EH K S
MEXICAN	M EH K S AH K AH N
MEXICO	M EH K S AH K OW
MIAMI	M AY AE M IY
MICHAEL	M AY K AH L
MICHIGAN	M IH SH IH G AH N
MICROWAVE	M AY K R AH W EY V
MID	M IH D
MIDDLE	M IH D AH L
MIDWEST	M IH D W EH S T
MIGHT	M AY T
MIKE	M AY K
MILD	M AY L D
MILE	M AY L
MILEAGE	M AY L AH JH
MILEAGE(2)	M AY L IH JH
MILES	M AY L Z
MILES(2)	M AY AH L Z
MILITARY	M IH L AH T EH R IY
MILITARY(2)	M IH L IH T EH R IY
MILK	M IH L K
MILL	M IH L
MILLION	M IH L Y AH N
MILLIONS	M IH L Y AH N Z
MILWAUKEE	M IH L W AO K IY
MIND	M AY N D
MINDED	M AY N D AH D
MINDED(2)	M AY N D IH D
MINDS	M AY N D Z
MINE	M AY N
MINE'S	M AY N Z
MINI	M IH N IY
MINIATURE	M IH N IY AH CH UH R
MINIATURE(2)	M IH N IH CH UH R
MINIMAL	M IH N AH M AH L
MINIMUM	M IH N AH M AH M
MINNEAPOLIS	M IH N IY AE P AH L IH S
MINNESOTA	M IH N IH S OW T AH
MINOR	M AY N ER
MINORITIES	M AY N AO R AH T IY Z
MINORITIES(2)	M AH N AO R AH T IY Z
MINORITY	M AY N AO R AH T IY
MINORITY(2)	M AH N AO R AH T IY
MINUTE	M IH N AH T
MINUTE(2)	M AY N UW T
MINUTE(3)	M AY N Y UW T
MINUTES	M IH N AH T S
MISERABLE	M IH Z ER AH B AH L
MISERABLE(2)	M IH Z R AH B AH L
MISS	M IH S
MISSED	M IH S T
MISSING	M IH S IH NG
MISSISSIPPI	M IH S IH S IH P IY
MISSOURI	M AH Z UH R IY
MISSOURI(2)	M AH Z ER AH
MISTAKE	M IH S T EY K
MISTAKES	M IH S T EY K S
MISTER	M IH S T ER
MIX	M IH K S
MIXED	M IH K S T
MIXTURE	M IH K S CH ER
MOBILE	M OW B AH L
MODE	M OW D
MODEL	M AA D AH L
MODELS	M AA D AH L Z
MODEM	M OW D AH M
MODERN	M AA D ER N
MOLDING	M OW L D IH NG
MOM	M AA M
MOM'S	M AA M Z
MOMENT	M OW M AH N T
MOMS	M AA M Z
MONDAY	M AH N D IY
MONDAY(2)	M AH N D EY
MONEY	M AH N IY
MONEY'S	M AH N IY Z
MONIES	M AH N IY Z
MONITOR	M AA N AH T ER
MONTANA	M AA N T AE N AH
MONTH	M AH N TH
MONTHLY	M AH N TH L IY
MONTHS	M AH N TH S
MOOD	M UW D
MOON	M UW N
MORAL	M AO R AH L
MORALS	M AO R AH L Z
MORE	M AO R
MORNING	M AO R N IH NG
MORNINGS	M AO R N IH NG Z
MORTGAGE	M AO R G AH JH
MORTGAGE(2)	M AO R G IH JH
MOST	M OW S T
MOST(2)	M OW S
MOSTLY	M OW S T L IY
MOSTLY(2)	M OW S L IY
MOTHER	M AH DH ER
MOTHER'S	M AH DH ER Z
MOTHERS	M AH DH ER Z
MOTIVATED	M OW T AH V EY T AH D
MOTIVATION	M OW T AH V EY SH AH N
MOTOR	M OW T ER
MOTORS	M OW T ER Z
MOUNTAIN	M AW N T AH N
MOUNTAINS	M AW N T AH N Z
MOUTH	M AW TH
MOVE	M UW V
MOVED	M UW V D
MOVEMENT	M UW V M AH N T
MOVES	M UW V Z
MOVIE	M UW V IY
MOVIES	M UW V IY Z
MOVING	M UW V IH NG
MOW	M OW
MOWER	M OW ER
MOWING	M AW IH NG
MUCH	M AH CH
MUD	M AH D
MULTIPLE	M AH L T AH P AH L
MURDER	M ER D ER
MURDERED	M ER D ER D
MURDERS	M ER D ER Z
MURPHY	M ER F IY
MUSCLE	M AH S AH L
MUSCLES	M AH S AH L Z
MUSIC	M Y UW Z IH K
MUSICAL	M Y UW Z IH K AH L
MUSICALS	M Y UW Z IH K AH L Z
MUSICIANS	M Y UW Z IH SH AH N Z
MUST	M AH S T
MUSTANG	M AH S T AE NG
MY	M AY
MYSELF	M AY S EH L F
MYSTERIES	M IH S T ER IY Z
MYSTERY	M IH S T ER IY
N.	EH N
NAME	N EY M
NAME'S	N EY M Z
NAMED	N EY M D
NAMES	N EY M Z
NANCY	N AE N S IY
NARROW	N EH R OW
NARROW(2)	N AE R OW
NASTY	N AE S T IY
NATION	N EY SH AH N
NATIONAL	N AE SH AH N AH L
NATIONAL(2)	N AE SH N AH L
NATIONS	N EY SH AH N Z
NATIONWIDE	N EY SH AH N W AY D
NATIVE	N EY T IH V
NATURAL	N AE CH ER AH L
NATURAL(2)	N AE CH R AH L
NATURALLY	N AE CH ER AH L IY
NATURALLY(2)	N AE CH R AH L IY
NATURE	N EY CH ER
NAUTILUS	N AO T AH L AH S
NAVY	N EY V IY
NEAR	N IH R
NEARBY	N IH R B AY
NEARLY	N IH R L IY
NEAT	N IY T
NEBRASKA	N AH B R AE S K AH
NECESSARILY	N EH S AH S EH R AH L IY
NECESSARY	N EH S AH S EH R IY
NECESSITY	N AH S EH S AH T IY
NECESSITY(2)	N AH S EH S IH T IY
NECK	N EH K
NEED	N IY D
NEEDED	N IY D AH D
NEEDED(2)	N IY D IH D
NEEDING	N IY D IH NG
NEEDLE	N IY D AH L
NEEDS	N IY D Z
NEGATIVE	N EH G AH T IH V
NEIGHBOR	N EY B ER
NEIGHBORHOOD	N EY B ER HH UH D
NEIGHBORHOODS	N EY B ER HH UH D Z
NEIGHBORS	N EY B ER Z
NEIL	N IY L
NEITHER	N IY DH ER
NEITHER(2)	N AY DH ER
NEPHEW	N EH F Y UW
NERVOUS	N ER V AH S
NET	N EH T
NETWORK	N EH T W ER K
NETWORKS	N EH T W ER K S
NEVER	N EH V ER
NEW	N UW
NEW(2)	N Y UW
NEWER	N UW ER
NEWS	N UW Z
NEWS(2)	N Y UW Z
NEWSPAPER	N UW Z P EY P ER
NEWSPAPERS	N UW Z P EY P ER Z
NEWSWEEK	N UW Z W IY K
NEXT	N EH K S T
NEXT(2)	N EH K S
NICE	N AY S
NICE(2)	N IY S
NICELY	N AY S L IY
NICER	N AY S ER
NICKEL	N IH K AH L
NIECE	N IY S
NIGHT	N AY T
NIGHTMARE	N AY T M EH R
NIGHTS	N AY T S
NINE	N AY N
NINERS	N AY N ER Z
NINETEEN	N AY N T IY N
NINETIES	N AY N T IY Z
NINETY	N AY N T IY
NINJA	N IH N JH AH
NINTENDO	N IH N T EH N D OW
NINTH	N AY N TH
NISSAN	N IY S AA N
NO	N OW
NOBODY	N OW B AA D IY
NOBODY(2)	N OW B AH D IY
NOBODY'S	N OW B AA D IY Z
NOBODY'S(2)	N OW B AH D IY Z
NOISE	N OY Z
NOISY	N OY Z IY
NOLAN	N OW L AH N
NON	N AA N
NONE	N AH N
NOON	N UW N
NOPE	N OW P
NOR	N AO R
NORM	N AO R M
NORMAL	N AO R M AH L
NORMALLY	N AO R M AH L IY
NORMALLY(2)	N AO R M L IY
NORTH	N AO R TH
NORTHEAST	N AO R TH IY S T
NORTHERN	N AO R DH ER N
NORTHWEST	N AO R TH W EH S T
NOSE	N OW Z
NOT	N AA T
NOTE	N OW T
NOTES	N OW T S
NOTHING	N AH TH IH NG
NOTICE	N OW T AH S
NOTICE(2)	N OW T IH S
NOTICED	N OW T AH S T
NOVEL	N AA V AH L
NOVELS	N AA V AH L Z
NOVEMBER	N OW V EH M B ER
NOW	N AW
NOWADAYS	N AW AH D EY Z
NOWHERE	N OW W EH R
NOWHERE(2)	N OW HH W EH R
NUCLEAR	N UW K L IY ER
NUMBER	N AH M B ER
NUMBERS	N AH M B ER Z
NURSE	N ER S
NURSERY	N ER S ER IY
NURSES	N ER S AH Z
NURSES(2)	N ER S IH Z
NURSING	N ER S IH NG
NUTS	N AH T S
O'CLOCK	AH K L AA K
O.	OW
OAK	OW K
OAKLAND	OW K L AH N D
OAKS	OW K S
OBJECT	AA B JH EH K T
OBJECT(2)	AH B JH EH K T
OBVIOUS	AA B V IY AH S
OBVIOUSLY	AA B V IY AH S L IY
OCCASION	AH K EY ZH AH N
OCCASIONAL	AH K EY ZH AH N AH L
OCCASIONALLY	AH K EY ZH AH N AH L IY
OCCASIONALLY(2)	AH K EY ZH N AH L IY
OCCASIONALLY(3)	AH K EY ZH AH N L IY
OCCASIONS	AH K EY ZH AH N Z
OCCUR	AH K ER
OCCURRED	AH K ER D
OCEAN	OW SH AH N
OCTOBER	AA K T OW B ER
ODD	AA D
OF	AH V
OF(2)	AH V
OFF	AO F
OFFENDERS	AH F EH N D ER Z
OFFENSE	AH F EH N S
OFFENSIVE	AH F EH N S IH V
OFFER	AO F ER
OFFERED	AO F ER D
OFFERING	AO F ER IH NG
OFFERING(2)	AO F R IH NG
OFFERS	AO F ER Z
OFFICE	AO F AH S
OFFICER	AO F AH S ER
OFFICER(2)	AO F IH S ER
OFFICERS	AO F AH S ER Z
OFFICERS(2)	AO F IH S ER Z
OFFICES	AO F AH S AH Z
OFFICES(2)	AO F AH S IH Z
OFTEN	AO F AH N
OFTEN(2)	AO F T AH N
OH	OW
OHIO	OW HH AY OW
OIL	OY L
OKAY	OW K EY
OKLAHOMA	OW K L AH HH OW M AH
OLD	OW L D
OLDER	OW L D ER
OLDEST	OW L D AH S T
OLDIES	OW L D IY Z
OLDS	OW L D Z
OLDSMOBILE	OW L D Z M OW B IY L
OLYMPICS	OW L IH M P IH K S
ON	AA N
ON(2)	AO N
ONCE	W AH N S
ONE	W AH N
ONE(2)	HH W AH N
ONE'S	W AH N Z
ONES	W AH N Z
ONION	AH N Y AH N
ONIONS	AH N Y AH N Z
ONLY	OW N L IY
ONTO	AA N T UW
ONTO(2)	AO N T UW
OPEN	OW P AH N
OPENED	OW P AH N D
OPENING	OW P AH N IH NG
OPERA	AA P R AH
OPERAS	AA P R AH Z
OPERATE	AA P ER EY T
OPERATE(2)	AO P ER EY T
OPERATING	AA P ER EY T IH NG
OPERATING(2)	AO P ER EY T IH NG
OPERATION	AA P ER EY SH AH N
OPINION	AH P IH N Y AH N
OPINIONS	AH P IH N Y AH N Z
OPPORTUNITIES	AA P ER T UW N AH T IY Z
OPPORTUNITY	AA P ER T UW N AH T IY
OPPOSED	AH P OW Z D
OPPOSITE	AA P AH Z AH T
OPPOSITE(2)	AA P Z AH T
OPTION	AA P SH AH N
OPTION(2)	AO P SH AH N
OPTIONS	AA P SH AH N Z
OPTIONS(2)	AO P SH AH N Z
OR	AO R
OR(2)	ER
ORANGE	AO R AH N JH
ORANGE(2)	AO R IH N JH
ORCHESTRA	AO R K AH S T R AH
ORDER	AO R D ER
ORDERED	AO R D ER D
OREGON	AO R AH G AH N
OREGON(2)	AO R AH G AA N
ORGANIZATION	AO R G AH N AH Z EY SH AH N
ORGANIZATIONS	AO R G AH N AH Z EY SH AH N Z
ORGANIZED	AO R G AH N AY Z D
ORIENTAL	AO R IY EH N T AH L
ORIENTAL(2)	AO R IY EH N AH L
ORIENTED	AO R IY EH N T AH D
ORIENTED(2)	AO R IY EH N T IH D
ORIGINAL	ER IH JH AH N AH L
ORIGINALLY	ER IH JH AH N AH L IY
ORIGINALLY(2)	ER IH JH N AH L IY
ORLANDO	AO R L AE N D OW
ORLEANS	AO R L IY AH N Z
ORLEANS(2)	AO R L IY N Z
OTHER	AH DH ER
OTHERS	AH DH ER Z
OTHERWISE	AH DH ER W AY Z
OUGHT	AO T
OUNCE	AW N S
OUNCES	AW N S AH Z
OUNCES(2)	AW N S IH Z
OUR	AW ER
OUR(2)	AW R
OUR(3)	AA R
OURS	AW ER Z
OURS(2)	AA R Z
OURSELVES	AW ER S EH L V Z
OURSELVES(2)	AA R S EH L V Z
OUT	AW T
OUTDOOR	AW T D AO R
OUTDOORS	AW T D AO R Z
OUTRAGEOUS	AW T R EY JH AH S
OUTS	AW T S
OUTSIDE	AW T S AY D
OUTSTANDING	AW T S T AE N D IH NG
OVEN	AH V AH N
OVER	OW V ER
OVERALL	OW V ER AO L
OVERBOARD	OW V ER B AO R D
OVERCROWDED	OW V ER K R AW D IH D
OVERCROWDING	OW V ER K R AW D IH NG
OVERHEAD	OW V ER HH EH D
OVERNIGHT	OW V ER N AY T
OVERSEAS	OW V ER S IY Z
OWE	OW
OWN	OW N
OWNED	OW N D
OWNER	OW N ER
OWNERS	OW N ER Z
OWNING	OW N IH NG
OWNS	OW N Z
OZONE	OW Z OW N
P.	P IY
PACE	P EY S
PACIFIC	P AH S IH F IH K
PACK	P AE K
PACKAGE	P AE K AH JH
PACKAGE(2)	P AE K IH JH
PACKAGES	P AE K AH JH AH Z
PACKAGES(2)	P AE K IH JH IH Z
PACKED	P AE K T
PACKING	P AE K IH NG
PADS	P AE D Z
PAGE	P EY JH
PAGES	P EY JH AH Z
PAGES(2)	P EY JH IH Z
PAID	P EY D
PAIN	P EY N
PAINFUL	P EY N F AH L
PAINT	P EY N T
PAINTED	P EY N T AH D
PAINTED(2)	P EY N T IH D
PAINTED(3)	P EY N AH D
PAINTED(4)	P EY N IH D
PAINTING	P EY N T IH NG
PAINTING(2)	P EY N IH NG
PAINTS	P EY N T S
PAIR	P EH R
PAN	P AE N
PANAMA	P AE N AH M AA
PANEL	P AE N AH L
PANELING	P AE N AH L IH NG
PANTS	P AE N T S
PAPER	P EY P ER
PAPERS	P EY P ER Z
PAPERWORK	P EY P ER W ER K
PAR	P AA R
PARDON	P AA R D AH N
PARENT	P EH R AH N T
PARENTAL	P ER EH N T AH L
PARENTS	P EH R AH N T S
PARENTS'	P EH R AH N T S
PARK	P AA R K
PARKING	P AA R K IH NG
PARKS	P AA R K S
PAROLE	P ER OW L
PART	P AA R T
PARTIAL	P AA R SH AH L
PARTIALLY	P AA R SH AH L IY
PARTIALLY(2)	P AA R SH L IY
PARTICIPATE	P AA R T IH S AH P EY T
PARTICIPATED	P AA R T IH S AH P EY T AH D
PARTICIPATED(2)	P AA R T IH S AH P EY T IH D
PARTICIPATING	P AA R T IH S AH P EY T IH NG
PARTICIPATION	P AA R T IH S AH P EY SH AH N
PARTICULAR	P ER T IH K Y AH L ER
PARTICULAR(2)	P AA T IH K Y AH L ER
PARTICULARLY	P AA R T IH K Y AH L ER L IY
PARTICULARLY(2)	P ER T IH K Y AH L ER L IY
PARTIES	P AA R T IY Z
PARTLY	P AA R T L IY
PARTS	P AA R T S
PARTY	P AA R T IY
PASO	P AE S OW
PASS	P AE S
PASSED	P AE S T
PASSING	P AE S IH NG
PAST	P AE S T
PASTA	P AA S T AH
PAT	P AE T
PATH	P AE TH
PATIENCE	P EY SH AH N S
PATIENT	P EY SH AH N T
PATIENTS	P EY SH AH N T S
PATIENTS(2)	P EY SH AH N Z
PATIO	P AE T IY OW
PATTERN	P AE T ER N
PATTERNS	P AE T ER N Z
PAUL	P AO L
PAY	P EY
PAYCHECK	P EY CH EH K
PAYING	P EY IH NG
PAYMENT	P EY M AH N T
PAYMENTS	P EY M AH N T S
PAYROLL	P EY R OW L
PAYS	P EY Z
PEACE	P IY S
PEACEFUL	P IY S F AH L
PEAKS	P IY K S
PEAS	P IY Z
PEER	P IH R
PEERS	P IH R Z
PENALTIES	P EH N AH L T IY Z
PENALTY	P EH N AH L T IY
PENN	P EH N
PENNSYLVANIA	P EH N S AH L V EY N Y AH
PENNY	P EH N IY
PENSION	P EH N SH AH N
PEOPLE	P IY P AH L
PEOPLE'S	P IY P AH L Z
PEOPLES	P IY P AH L Z
PEPPER	P EH P ER
PEPPERS	P EH P ER Z
PER	P ER
PERCENT	P ER S EH N T
PERCENTAGE	P ER S EH N T AH JH
PERCENTAGE(2)	P ER S EH N AH JH
PERCENTAGE(3)	P ER S EH N T IH JH
PERCENTAGE(4)	P ER S EH N IH JH
PERFECT	P ER F EH K T
PERFECT(2)	P ER F IH K T
PERFECTLY	P ER F AH K T L IY
PERFECTLY(2)	P ER F AH K L IY
PERFORM	P ER F AO R M
PERFORMANCE	P ER F AO R M AH N S
PERHAPS	P ER HH AE P S
PERIOD	P IH R IY AH D
PERIODS	P IH R IY AH D Z
PERKINS	P ER K AH N Z
PERKINS(2)	P ER K IH N Z
PERMANENT	P ER M AH N AH N T
PERMISSION	P ER M IH SH AH N
PERMIT	P ER M IH T
PERMIT(2)	P ER M IH T
PERSIAN	P ER ZH AH N
PERSON	P ER S AH N
PERSON'S	P ER S AH N Z
PERSONAL	P ER S IH N IH L
PERSONALITIES	P ER S AH N AE L IH T IY Z
PERSONALITY	P ER S AH N AE L IH T IY
PERSONALLY	P ER S AH N AH L IY
PERSONALLY(2)	P ER S AH N L IY
PERSONALLY(3)	P ER S N AH L IY
PERSONNEL	P ER S AH N EH L
PERSONS	P ER S AH N Z
PERSPECTIVE	P ER S P EH K T IH V
PET	P EH T
PETER	P IY T ER
PETS	P EH T S
PHASE	F EY Z
PHENOMENAL	F AH N AA M AH N AH L
PHILADELPHIA	F IH L AH D EH L F IY AH
PHILIPPINES	F IH L AH P IY N Z
PHILOSOPHY	F AH L AA S AH F IY
PHOENIX	F IY N IH K S
PHONE	F OW N
PHONES	F OW N Z
PHOTOGRAPHY	F AH T AA G R AH F IY
PHYSICAL	F IH Z IH K AH L
PHYSICALLY	F IH Z IH K AH L IY
PHYSICALLY(2)	F IH Z IH K L IY
PHYSICIAN	F AH Z IH SH AH N
PHYSICS	F IH Z IH K S
PIANO	P IY AE N OW
PIANO(2)	P IY AE N AH
PICK	P IH K
PICKED	P IH K T
PICKING	P IH K IH NG
PICKS	P IH K S
PICKUP	P IH K AH P
PICKY	P IH K IY
PICNIC	P IH K N IH K
PICTURE	P IH K CH ER
PICTURES	P IH K CH ER Z
PIE	P AY
PIECE	P IY S
PIECES	P IY S AH Z
PIECES(2)	P IY S IH Z
PIER	P IH R
PIG	P IH G
PILE	P AY L
PILOT	P AY L AH T
PILOTS	P AY L AH T S
PIN	P IH N
PINE	P AY N
PINK	P IH NG K
PIPE	P AY P
PISTOL	P IH S T AH L
PIT	P IH T
PITCH	P IH CH
PITCHED	P IH CH T
PITCHING	P IH CH IH NG
PITTSBURGH	P IH T S B ER G
PIZZA	P IY T S AH
PLACE	P L EY S
PLACED	P L EY S T
PLACES	P L EY S AH Z
PLACES(2)	P L EY S IH Z
PLAIN	P L EY N
PLAN	P L AE N
PLANE	P L EY N
PLANES	P L EY N Z
PLANET	P L AE N AH T
PLANNED	P L AE N D
PLANNING	P L AE N IH NG
PLANO	P L EY N OW
PLANS	P L AE N Z
PLANT	P L AE N T
PLANTED	P L AE N T AH D
PLANTED(2)	P L AE N T IH D
PLANTED(3)	P L AE N AH D
PLANTED(4)	P L AE N IH D
PLANTING	P L AE N T IH NG
PLANTS	P L AE N T S
PLASTIC	P L AE S T IH K
PLASTICS	P L AE S T IH K S
PLATE	P L EY T
PLATES	P L EY T S
PLAY	P L EY
PLAYED	P L EY D
PLAYER	P L EY ER
PLAYERS	P L EY ER Z
PLAYING	P L EY IH NG
PLAYOFFS	P L EY AO F S
PLAYS	P L EY Z
PLEA	P L IY
PLEASANT	P L EH Z AH N T
PLEASE	P L IY Z
PLEASED	P L IY Z D
PLEASURE	P L EH ZH ER
PLENTY	P L EH N T IY
PLENTY(2)	P L EH N IY
PLOT	P L AA T
PLUG	P L AH G
PLUGS	P L AH G Z
PLUMBING	P L AH M IH NG
PLUS	P L AH S
PLYMOUTH	P L IH M AH TH
POCKET	P AA K AH T
POCKETS	P AA K AH T S
POINT	P OY N T
POINTED	P OY N T AH D
POINTED(2)	P OY N AH D
POINTED(3)	P OY N T IH D
POINTS	P OY N T S
POLICE	P AH L IY S
POLICEMAN	P AH L IY S M AH N
POLICEMEN	P AH L IY S M IH N
POLICIES	P AA L AH S IY Z
POLICY	P AA L AH S IY
POLITICAL	P AH L IH T AH K AH L
POLITICAL(2)	P AH L IH T IH K AH L
POLITICALLY	P AH L IH T IH K AH L IY
POLITICALLY(2)	P L IH T IH K L IY
POLITICIANS	P AA L AH T IH SH AH N Z
POLITICS	P AA L AH T IH K S
POLLS	P OW L Z
POLLUTANTS	P AH L UW T AH N T S
POLLUTED	P AH L UW T AH D
POLLUTED(2)	P AH L UW T IH D
POLLUTION	P AH L UW SH AH N
POND	P AA N D
PONTIAC	P AA N T IY AE K
PONTIAC(2)	P AA N IY AE K
POOL	P UW L
POOR	P UH R
POORER	P UH R ER
POP	P AA P
POPCORN	P AA P K AO R N
POPULAR	P AA P Y AH L ER
POPULATION	P AA P Y AH L EY SH AH N
PORCH	P AO R CH
PORK	P AO R K
PORTABLE	P AO R T AH B AH L
PORTION	P AO R SH AH N
PORTLAND	P AO R T L AH N D
POSITION	P AH Z IH SH AH N
POSITIONS	P AH Z IH SH AH N Z
POSITIVE	P AA Z AH T IH V
POSSIBILITY	P AA S AH B IH L AH T IY
POSSIBLE	P AA S AH B AH L
POSSIBLY	P AA S AH B L IY
POST	P OW S T
POT	P AA T
POTATO	P AH T EY T OW
POTATOES	P AH T EY T OW Z
POTENTIAL	P AH T EH N SH AH L
POTENTIAL(2)	P AH T EH N CH AH L
POUND	P AW N D
POUNDS	P AW N D Z
POUNDS(2)	P AW N Z
POUR	P AO R
POVERTY	P AA V ER T IY
POWER	P AW ER
POWERED	P AW ER D
POWERFUL	P AW ER F AH L
PRACTICAL	P R AE K T AH K AH L
PRACTICAL(2)	P R AE K T IH K AH L
PRACTICALLY	P R AE K T AH K L IY
PRACTICALLY(2)	P R AE K T AH K AH L IY
PRACTICE	P R AE K T AH S
PRACTICE(2)	P R AE K T IH S
PRACTICING	P R AE K T AH S IH NG
PRE	P R IY
PRECIOUS	P R EH SH AH S
PREFER	P R AH F ER
PREFER(2)	P R IH F ER
PREFER(3)	P R IY F ER
PREFERENCE	P R EH F ER AH N S
PREFERENCE(2)	P R EH F R AH N S
PREFERRED	P R AH F ER D
PREFERRED(2)	P R IH F ER D
PREFERRED(3)	P R IY F ER D
PREGNANT	P R EH G N AH N T
PREJUDICE	P R EH JH AH D IH S
PREMEDITATED	P R IY M EH D AH T EY T IH D
PREMIUM	P R IY M IY AH M
PREPARE	P R IY P EH R
PREPARED	P R IY P EH R D
PREPARING	P R IY P EH R IH NG
PREPARING(2)	P ER P EH R IH NG
PRESCHOOL	P R IY S K UW L
PRESCHOOL(2)	P R IY S K UW L
PRESCRIPTION	P R AH S K R IH P SH AH N
PRESCRIPTIONS	P R AH S K R IH P SH AH N Z
PRESENT	P R EH Z AH N T
PRESENT(2)	P R IY Z EH N T
PRESENT(3)	P ER Z EH N T
PRESENTED	P R IY Z EH N T AH D
PRESENTED(2)	P ER Z EH N T AH D
PRESENTED(3)	P R IY Z EH N AH D
PRESENTED(4)	P ER Z EH N AH D
PRESENTS	P R EH Z AH N T S
PRESENTS(2)	P R IY Z EH N T S
PRESIDENT	P R EH Z AH D EH N T
PRESIDENT(2)	P R EH Z IH D AH N T
PRESIDENT'S	P R EH Z IH D AH N T S
PRESIDENTIAL	P R EH Z AH D EH N CH AH L
PRESIDENTIAL(2)	P R EH Z AH D EH N SH AH L
PRESS	P R EH S
PRESSED	P R EH S T
PRESSURE	P R EH SH ER
PRESSURES	P R EH SH ER Z
PRETTY	P R IH T IY
PREVALENT	P R EH V AH L AH N T
PREVENT	P R IH V EH N T
PREVENT(2)	P R IY V EH N T
PREVIOUS	P R IY V IY AH S
PRICE	P R AY S
PRICED	P R AY S T
PRICES	P R AY S AH Z
PRICES(2)	P R AY S IH Z
PRIDE	P R AY D
PRIMARILY	P R AY M EH R AH L IY
PRIMARY	P R AY M EH R IY
PRIME	P R AY M
PRINCIPAL	P R IH N S AH P AH L
PRINT	P R IH N T
PRINTED	P R IH N T AH D
PRINTED(2)	P R IH N T IH D
PRINTED(3)	P R IH N AH D
PRINTED(4)	P R IH N IH D
PRINTER	P R IH N T ER
PRINTER(2)	P R IH N ER
PRIOR	P R AY ER
PRIORITIES	P R AY AO R AH T IY Z
PRIORITY	P R AY AO R AH T IY
PRISON	P R IH Z AH N
PRISONERS	P R IH Z AH N ER Z
PRISONERS(2)	P R IH Z N ER Z
PRISONS	P R IH Z AH N Z
PRIVACY	P R AY V AH S IY
PRIVATE	P R AY V AH T
PRIVILEGE	P R IH V L AH JH
PRIVILEGE(2)	P R IH V L IH JH
PRIVILEGE(3)	P R IH V IH L AH JH
PRIVILEGE(4)	P R IH V IH L IH JH
PRO	P R OW
PROBABLY	P R AA B AH B L IY
PROBABLY(2)	P R AA B L IY
PROBATION	P R OW B EY SH AH N
PROBLEM	P R AA B L AH M
PROBLEMS	P R AA B L AH M Z
PROCESS	P R AA S EH S
PROCESS(2)	P R AO S EH S
PROCESSING	P R AA S EH S IH NG
PROCESSOR	P R AA S EH S ER
PRODUCE	P R AH D UW S
PRODUCE(2)	P R OW D UW S
PRODUCED	P R AH D UW S T
PRODUCING	P R AH D UW S IH NG
PRODUCT	P R AA D AH K T
PRODUCTION	P R AH D AH K SH AH N
PRODUCTION(2)	P R OW D AH K SH AH N
PRODUCTION(3)	P ER D AH K SH AH N
PRODUCTIVE	P R AH D AH K T IH V
PRODUCTIVE(2)	P R OW D AH K T IH V
PRODUCTIVE(3)	P ER D AH K T IH V
PRODUCTS	P R AA D AH K T S
PRODUCTS(2)	P R AA D AH K S
PROFESSION	P R AH F EH SH AH N
PROFESSIONAL	P R AH F EH SH AH N AH L
PROFESSIONALS	P R AH F EH SH AH N AH L Z
PROFESSIONS	P R AH F EH SH AH N Z
PROFESSOR	P R AH F EH S ER
PROFESSORS	P R AH F EH S ER Z
PROFIT	P R AA F AH T
PROFIT(2)	P R AA F IH T
PROGRAM	P R OW G R AE M
PROGRAMMING	P R OW G R AE M IH NG
PROGRAMS	P R OW G R AE M Z
PROGRESS	P R AA G R EH S
PROGRESS(2)	P R AH G R EH S
PROGRESS(3)	P R OW G R EH S
PROGRESSIVE	P R AH G R EH S IH V
PROHIBITIVE	P R OW HH IH B AH T IH V
PROJECT	P R AA JH EH K T
PROJECT(2)	P R AH JH EH K T
PROJECTS	P R AA JH EH K T S
PROJECTS(2)	P R AH JH EH K T S
PROJECTS(3)	P R AA JH EH K S
PROJECTS(4)	P R AH JH EH K S
PROMISED	P R AA M AH S T
PROMOTE	P R AH M OW T
PROOF	P R UW F
PROPER	P R AA P ER
PROPERLY	P R AA P ER L IY
PROPERTY	P R AA P ER T IY
PROPORTION	P R AH P AO R SH AH N
PROPOSAL	P R AH P OW Z AH L
PROS	P R OW Z
PROTECT	P R AH T EH K T
PROTECT(2)	P ER T EH K T
PROTECTED	P R AH T EH K T AH D
PROTECTED(2)	P R AH T EH K T IH D
PROTECTED(3)	P ER T EH K T IH D
PROTECTING	P R AH T EH K T IH NG
PROTECTING(2)	P ER T EH K T IH NG
PROTECTION	P R AH T EH K SH AH N
PROTECTION(2)	P ER T EH K SH AH N
PROTECTIVE	P R AH T EH K T IH V
PROTECTIVE(2)	P ER T EH K T IH V
PROUD	P R AW D
PROVE	P R UW V
PROVED	P R UW V D
PROVEN	P R UW V AH N
PROVIDE	P R AH V AY D
PROVIDED	P R AH V AY D AH D
PROVIDED(2)	P R AH V AY D IH D
PROVIDER	P R AH V AY D ER
PROVIDES	P R AH V AY D Z
PROVIDING	P R AH V AY D IH NG
PSYCHOLOGY	S AY K AA L AH JH IY
PUBLIC	P AH B L IH K
PUBLICITY	P AH B L IH S AH T IY
PUBLICITY(2)	P AH B L IH S IH T IY
PUBLISHED	P AH B L IH SH T
PUERTO	P W EH R T OW
PUERTO(2)	P AO R T AH
PUERTO(3)	P AO R T ER
PULL	P UH L
PULLED	P UH L D
PULLING	P UH L IH NG
PUMP	P AH M P
PUNCH	P AH N CH
PUNISHED	P AH N IH SH T
PUNISHMENT	P AH N IH SH M AH N T
PUPPIES	P AH P IY Z
PUPPY	P AH P IY
PURCHASE	P ER CH AH S
PURCHASED	P ER CH AH S T
PURCHASES	P ER CH AH S AH Z
PURCHASES(2)	P ER CH AH S IH Z
PURCHASING	P ER CH AH S IH NG
PURDUE	P ER D UW
PURE	P Y UH R
PURELY	P Y UH R L IY
PURPLE	P ER P AH L
PURPOSE	P ER P AH S
PURPOSES	P ER P AH S AH Z
PURPOSES(2)	P ER P AH S IH Z
PURSE	P ER S
PUSH	P UH SH
PUSHED	P UH SH T
PUSHING	P UH SH IH NG
PUT	P UH T
PUTS	P UH T S
PUTTING	P AH T IH NG
PUTTING(2)	P UH T IH NG
QUALIFIED	K W AA L AH F AY D
QUALIFY	K W AA L AH F AY
QUALITY	K W AA L AH T IY
QUARTER	K W AO R T ER
QUARTER(2)	K AO R T ER
QUARTERBACK	K W AO R T ER B AE K
QUARTERBACK(2)	K AO R T ER B AE K
QUARTERS	K W AO R T ER Z
QUESTION	K W EH S CH AH N
QUESTION(2)	K W EH SH AH N
QUESTIONS	K W EH S CH AH N Z
QUICK	K W IH K
QUICKER	K W IH K ER
QUICKLY	K W IH K L IY
QUIET	K W AY AH T
QUILT	K W IH L T
QUILTING	K W IH L T IH NG
QUIT	K W IH T
QUITE	K W AY T
QUOTE	K W OW T
R.	AA R
RABBIT	R AE B AH T
RABBIT(2)	R AE B IH T
RABBITS	R AE B AH T S
RACE	R EY S
RACES	R EY S AH Z
RACES(2)	R EY S IH Z
RACIAL	R EY SH AH L
RACING	R EY S IH NG
RACQUETBALL	R AE K AH T B AO L
RADIATOR	R EY D IY EY T ER
RADICAL	R AE D AH K AH L
RADICAL(2)	R AE D IH K AH L
RADIO	R EY D IY OW
RAIDERS	R EY D ER Z
RAIL	R EY L
RAILROAD	R EY L R OW D
RAIN	R EY N
RAINED	R EY N D
RAINING	R EY N IH NG
RAINS	R EY N Z
RAINY	R EY N IY
RAISE	R EY Z
RAISED	R EY Z D
RAISES	R EY Z AH Z
RAISES(2)	R EY Z IH Z
RAISING	R EY Z IH NG
RAKE	R EY K
RALEIGH	R AO L IY
RAN	R AE N
RANCH	R AE N CH
RANDOM	R AE N D AH M
RANDOMLY	R AE N D AH M L IY
RANGE	R EY N JH
RANGER	R EY N JH ER
RANGERS	R EY N JH ER Z
RANK	R AE NG K
RAP	R AE P
RAPE	R EY P
RAPED	R EY P T
RAPID	R AE P AH D
RAPID(2)	R AE P IH D
RAPIDLY	R AE P AH D L IY
RARE	R EH R
RARELY	R EH R L IY
RAT	R AE T
RATE	R EY T
RATED	R EY T AH D
RATED(2)	R EY T IH D
RATES	R EY T S
RATHER	R AE DH ER
RATHER(2)	R AH DH ER
RATING	R EY T IH NG
RATIO	R EY SH IY OW
RAW	R AA
RE	R EY
RE(2)	R IY
REACH	R IY CH
REACHED	R IY CH T
REACT	R IY AE K T
REACTION	R IY AE K SH AH N
READ	R EH D
READ(2)	R IY D
READING	R EH D IH NG
READING(2)	R IY D IH NG
READS	R IY D Z
READY	R EH D IY
REAGAN	R EY G AH N
REAGAN(2)	R IY G AH N
REAL	R IY L
REALISTIC	R IY AH L IH S T IH K
REALITY	R IY AE L AH T IY
REALIZE	R IY L AY Z
REALIZE(2)	R IY AH L AY Z
REALIZED	R IY L AY Z D
REALIZED(2)	R IY AH L AY Z D
REALIZING	R IY L AY Z IH NG
REALIZING(2)	R IY AH L AY Z IH NG
REALLY	R IH L IY
REALLY(2)	R IY L IY
REALM	R EH L M
REAR	R IH R
REASON	R IY Z AH N
REASONABLE	R IY Z AH N AH B AH L
REASONABLE(2)	R IY Z N AH B AH L
REASONABLY	R IY Z AH N AH B L IY
REASONS	R IY Z AH N Z
REBUILD	R IY B IH L D
REBUILT	R IY B IH L T
RECALL	R IY K AO L
RECALL(2)	R IH K AO L
RECEIVE	R AH S IY V
RECEIVE(2)	R IH S IY V
RECEIVE(3)	R IY S IY V
RECEIVED	R AH S IY V D
RECEIVED(2)	R IH S IY V D
RECEIVED(3)	R IY S IY V D
RECENT	R IY S AH N T
RECENTLY	R IY S AH N T L IY
RECENTLY(2)	R IY S AH N L IY
RECESSION	R IH S EH SH AH N
RECESSION(2)	R IY S EH SH AH N
RECIPE	R EH S AH P IY
RECIPES	R EH S AH P IY Z
RECOGNITION	R EH K AH G N IH SH AH N
RECOGNITION(2)	R EH K IH G N IH SH AH N
RECOGNIZE	R EH K AH G N AY Z
RECOGNIZED	R EH K AH G N AY Z D
RECOMMEND	R EH K AH M EH N D
RECOMMENDED	R EH K AH M EH N D AH D
RECOMMENDED(2)	R EH K AH M EH N D IH D
RECORD	R AH K AO R D
RECORD(2)	R EH K ER D
RECORD(3)	R IH K AO R D
RECORDED	R AH K AO R D AH D
RECORDED(2)	R IH K AO R D IH D
RECORDING	R AH K AO R D IH NG
RECORDING(2)	R IH K AO R D IH NG
RECORDS	R AH K AO R D Z
RECORDS(2)	R EH K ER D Z
RECORDS(3)	R IH K AO R D Z
RECREATION	R EH K R IY EY SH AH N
RECYCLABLE	R IY S AY K L AH B AH L
RECYCLE	R IY S AY K AH L
RECYCLED	R IY S AY K AH L D
RECYCLING	R IY S AY K AH L IH NG
RECYCLING(2)	R IY S AY K L IH NG
RED	R EH D
REDO	R IY D UW
REDONE	R IY D AH N
REDUCE	R AH D UW S
REDUCE(2)	R IH D UW S
REDUCE(3)	R IY D UW S
REDUCED	R AH D UW S T
REDUCED(2)	R IH D UW S T
REDUCED(3)	R IY D UW S T
REDWOOD	R EH D W UH D
REFERENCE	R EH F ER AH N S
REFERENCE(2)	R EH F R AH N S
REFERENCES	R EH F ER AH N S IH Z
REFERENCES(2)	R EH F R AH N S IH Z
REFORM	R AH F AO R M
REFORM(2)	R IH F AO R M
REFRIGERATOR	R AH F R IH JH ER EY T ER
REFRIGERATOR(2)	R IH F R IH JH ER EY T ER
REFUND	R IH F AH N D
REFUND(2)	R IY F AH N D
REFUSE	R AH F Y UW Z
REFUSE(2)	R EH F Y UW Z
REFUSE(3)	R IH F Y UW Z
REFUSED	R AH F Y UW Z D
REFUSED(2)	R IH F Y UW Z D
REGARD	R AH G AA R D
REGARD(2)	R IH G AA R D
REGARDING	R AH G AA R D IH NG
REGARDING(2)	R IH G AA R D IH NG
REGARDLESS	R AH G AA R D L AH S
REGION	R IY JH AH N
REGISTER	R EH JH IH S T ER
REGISTERED	R EH JH IH S T ER D
REGISTRATION	R EH JH IH S T R EY SH AH N
REGISTRATION(2)	R EH JH IH S T R EY SH AH N
REGULAR	R EH G Y AH L ER
REGULAR(2)	R EY G Y AH L ER
REGULARLY	R EH G Y AH L ER L IY
REGULATE	R EH G Y AH L EY T
REGULATION	R EH G Y AH L EY SH AH N
REGULATIONS	R EH G Y AH L EY SH AH N Z
REHABILITATION	R IY HH AH B IH L AH T EY SH AH N
REHABILITATION(2)	R IY AH B IH L AH T EY SH AH N
RELATE	R IH L EY T
RELATE(2)	R IY L EY T
RELATED	R IH L EY T IH D
RELATED(2)	R IY L EY T AH D
RELATED(3)	R IY L EY T IH D
RELATIONS	R IY L EY SH AH N Z
RELATIONSHIP	R IY L EY SH AH N SH IH P
RELATIONSHIPS	R IY L EY SH AH N SH IH P S
RELATIVE	R EH L AH T IH V
RELATIVELY	R EH L AH T IH V L IY
RELATIVES	R EH L AH T IH V Z
RELAX	R IH L AE K S
RELAX(2)	R IY L AE K S
RELAXED	R IH L AE K S T
RELAXED(2)	R IY L AE K S T
RELAXING	R IH L AE K S IH NG
RELAXING(2)	R IY L AE K S IH NG
RELEASE	R IY L IY S
RELEASED	R IY L IY S T
RELIABILITY	R IY L AY AH B IH L AH T IY
RELIABLE	R IH L AY AH B AH L
RELIABLE(2)	R IY L AY AH B AH L
RELIEF	R IH L IY F
RELIEF(2)	R IY L IY F
RELIGION	R IH L IH JH AH N
RELIGION(2)	R IY L IH JH AH N
RELIGIOUS	R IH L IH JH AH S
RELIGIOUS(2)	R IY L IH JH AH S
RELIGIOUSLY	R IH L IH JH AH S L IY
RELUCTANT	R IH L AH K T AH N T
RELUCTANT(2)	R IY L AH K T AH N T
RELY	R IH L AY
RELY(2)	R IY L AY
REMARKABLE	R IH M AA R K AH B AH L
REMARKABLE(2)	R IY M AA R K AH B AH L
REMEMBER	R IH M EH M B ER
REMEMBER(2)	R IY M EH M B ER
REMINDS	R IY M AY N D Z
REMODELING	R IH M AA D AH L IH NG
REMODELING(2)	R IH M AA D L IH NG
REMOTE	R IH M OW T
REMOTE(2)	R IY M OW T
REMOVE	R IY M UW V
REMOVED	R IY M UW V D
RENT	R EH N T
RENTAL	R EH N T AH L
RENTED	R EH N T AH D
RENTED(2)	R EH N T IH D
RENTING	R EH N T IH NG
REPAIR	R IH P EH R
REPAIRED	R IH P EH R D
REPAIRED(2)	R IY P EH R D
REPAIRS	R IH P EH R Z
REPAIRS(2)	R IY P EH R Z
REPEAT	R IH P IY T
REPEAT(2)	R IY P IY T
REPLACE	R IY P L EY S
REPLACE(2)	ER P L EY S
REPLACED	R IY P L EY S T
REPORT	R IY P AO R T
REPORT(2)	R IH P AO R T
REPORTED	R IY P AO R T AH D
REPORTED(2)	R IH P AO R T AH D
REPORTER	R IH P AO R T ER
REPORTING	R IY P AO R T IH NG
REPORTING(2)	R IH P AO R T IH NG
REPORTS	R IH P AO R T S
REPORTS(2)	R IY P AO R T S
REPRESENT	R EH P R AH Z EH N T
REPRESENT(2)	R EH P R IH Z EH N T
REPRESENTED	R EH P R AH Z EH N T AH D
REPRESENTED(2)	R EH P R IH Z EH N T IH D
REPRESENTED(3)	R EH P R AH Z EH N AH D
REPRESENTED(4)	R EH P R IH Z EH N IH D
REPUBLICAN	R IH P AH B L IH K AH N
REPUBLICAN(2)	R IY P AH B L AH K AH N
REPUBLICAN(3)	R IY P AH B L IH K AH N
REPUBLICS	R IY P AH B L IH K S
REPUTATION	R EH P Y AH T EY SH AH N
REQUIRE	R IY K W AY ER
REQUIRE(2)	R IY K W AY R
REQUIRE(3)	R IH K W AY ER
REQUIRED	R IY K W AY ER D
REQUIRED(2)	R IY K W AY R D
REQUIREMENT	R IH K W AY R M AH N T
REQUIREMENTS	R IH K W AY R M AH N T S
REQUIRES	R IY K W AY ER Z
REQUIRES(2)	R IY K W AY R Z
RERUNS	R IY R AH N Z
RESEARCH	R IY S ER CH
RESEARCH(2)	R IY S ER CH
RESIDENTIAL	R EH Z IH D EH N CH AH L
RESORT	R IH Z AO R T
RESORT(2)	R IY Z AO R T
RESORT(3)	R IY S AO R T
RESOURCE	R IY S AO R S
RESOURCES	R IY S AO R S IH Z
RESPECT	R IH S P EH K T
RESPECT(2)	R IY S P EH K T
RESPECTED	R IH S P EH K T IH D
RESPECTED(2)	R IY S P EH K T AH D
RESPECTED(3)	R IY S P EH K T IH D
RESPOND	R IH S P AA N D
RESPOND(2)	R IY S P AA N D
RESPONSE	R IH S P AA N S
RESPONSE(2)	R IY S P AA N S
RESPONSIBILITIES	R IY S P AA N S AH B IH L AH T IY Z
RESPONSIBILITY	R IY S P AA N S AH B IH L AH T IY
RESPONSIBLE	R IY S P AA N S AH B AH L
REST	R EH S T
RESTAURANT	R EH S T ER AA N T
RESTAURANT(2)	R EH S T R AA N T
RESTAURANTS	R EH S T ER AA N T S
RESTAURANTS(2)	R EH S T R AA N T S
RESTRICTED	R IY S T R IH K T AH D
RESTRICTED(2)	R IY S T R IH K T IH D
RESTRICTIONS	R IY S T R IH K SH AH N Z
RESULT	R IH Z AH L T
RESULT(2)	R IY Z AH L T
RESULTS	R IH Z AH L T S
RESULTS(2)	R IY Z AH L T S
RETIRE	R IH T AY R
RETIRE(2)	R IY T AY R
RETIRE(3)	R IY T AY ER
RETIRED	R IH T AY R D
RETIRED(2)	R IY T AY ER D
RETIRED(3)	R IY T AY R D
RETIREMENT	R IY T AY ER M AH N T
RETIREMENT(2)	R IH T AY ER M AH N T
RETRIEVER	R IY T R IY V ER
RETURN	R IH T ER N
RETURN(2)	R IY T ER N
RETURNED	R IH T ER N D
RETURNED(2)	R IY T ER N D
REUNION	R IY UW N Y AH N
REUNIONS	R IY UW N Y AH N Z
REVENUE	R EH V AH N UW
REVENUE(2)	R EH V AH N Y UW
REVERSE	R IH V ER S
REVERSE(2)	R IY V ER S
REVIEW	R IY V Y UW
REVIEWS	R IY V Y UW Z
REVIEWS(2)	R AH V Y UW Z
RHODE	R OW D
RIB	R IH B
RICE	R AY S
RICH	R IH CH
RICHARD	R IH CH ER D
RICHARDSON	R IH CH ER D S AH N
RICHLAND	R IH CH L AH N D
RICHLAND(2)	R IH CH L AE N
RICO	R IY K OW
RID	R IH D
RIDE	R AY D
RIDES	R AY D Z
RIDICULOUS	R IH D IH K Y AH L AH S
RIDING	R AY D IH NG
RIFLE	R AY F AH L
RIFLES	R AY F AH L Z
RIGHT	R AY T
RIGHTS	R AY T S
RIGHTY	R AY T IY
RING	R IH NG
RINGS	R IH NG Z
RIP	R IH P
RIPPED	R IH P T
RISE	R AY Z
RISING	R AY Z IH NG
RISK	R IH S K
RIVER	R IH V ER
ROAD	R OW D
ROADS	R OW D Z
ROAST	R OW S T
ROB	R AA B
ROBBERY	R AA B ER IY
ROBERT	R AA B ER T
ROBIN	R AA B AH N
ROBIN(2)	R AA B IH N
ROCHESTER	R AA CH EH S T ER
ROCK	R AA K
ROCKS	R AA K S
ROLE	R OW L
ROLES	R OW L Z
ROLL	R OW L
ROLLER	R OW L ER
ROLLING	R OW L IH NG
ROLLS	R OW L Z
ROOF	R UW F
ROOM	R UW M
ROOMMATE	R UW M EY T
ROOMS	R UW M Z
ROOT	R UW T
ROOTS	R UW T S
ROSE	R OW Z
ROSES	R OW Z IH Z
ROUGH	R AH F
ROUGHING	R AH F IH NG
ROUGHLY	R AH F L IY
ROUND	R AW N D
ROUTE	R UW T
ROUTE(2)	R AW T
ROUTINE	R UW T IY N
ROW	R OW
RUDE	R UW D
RUIN	R UW AH N
RUIN(2)	R UW IH N
RUINED	R UW AH N D
RUINED(2)	R UW IH N D
RULE	R UW L
RULES	R UW L Z
RUN	R AH N
RUNNING	R AH N IH NG
RUNS	R AH N Z
RURAL	R UH R AH L
RUSH	R AH SH
RUSSIA	R AH SH AH
RUSSIAN	R AH SH AH N
RUST	R AH S T
RYAN	R AY AH N
S.	EH S
SACKS	S AE K S
SACRIFICE	S AE K R AH F AY S
SAD	S AE D
SADDAM	S AA D AH M
SADDAM(2)	S AH D AA M
SAFE	S EY F
SAFER	S EY F ER
SAFETY	S EY F T IY
SAID	S EH D
SAIL	S EY L
SAILING	S EY L IH NG
SAINT	S EY N T
SAKE	S EY K
SALAD	S AE L AH D
SALARIES	S AE L ER IY Z
SALARY	S AE L ER IY
SALE	S EY L
SALES	S EY L Z
SALESMAN	S EY L Z M AH N
SALMON	S AE M AH N
SALT	S AO L T
SAM	S AE M
SAM'S	S AE M Z
SAME	S EY M
SAMPLE	S AE M P AH L
SAN	S AE N
SAND	S AE N D
SANDY	S AE N D IY
SANG	S AE NG
SANTA	S AE N T AH
SANTA(2)	S AE N AH
SAT	S AE T
SATISFACTION	S AE T AH S F AE K SH AH N
SATISFACTION(2)	S AE T IH S F AE K SH AH N
SATISFIED	S AE T AH S F AY D
SATISFIED(2)	S AE T IH S F AY D
SATURDAY	S AE T ER D IY
SATURDAY(2)	S AE T IH D EY
SATURDAYS	S AE T ER D IY Z
SATURDAYS(2)	S AE T ER D EY Z
SAUCE	S AO S
SAUDI	S AO D IY
SAUDI(2)	S AW D IY
SAUSAGE	S AO S AH JH
SAUSAGE(2)	S AO S IH JH
SAVE	S EY V
SAVED	S EY V D
SAVES	S EY V Z
SAVING	S EY V IH NG
SAVINGS	S EY V IH NG Z
SAW	S AO
SAY	S EY
SAYING	S EY IH NG
SAYS	S EH Z
SAYS(2)	S IH Z
SCALE	S K EY L
SCARE	S K EH R
SCARED	S K EH R D
SCARES	S K EH R Z
SCARY	S K EH R IY
SCATTERED	S K AE T ER D
SCENE	S IY N
SCENERY	S IY N ER IY
SCENES	S IY N Z
SCHEDULE	S K EH JH UH L
SCHEDULE(2)	S K EH JH UW L
SCHNAUZER	SH N AW Z ER
SCHOLARSHIPS	S K AA L ER SH IH P S
SCHOOL	S K UW L
SCHOOLING	S K UW L IH NG
SCHOOLS	S K UW L Z
SCIENCE	S AY AH N S
SCIENTIFIC	S AY AH N T IH F IH K
SCIENTIST	S AY AH N T IH S T
SCORE	S K AO R
SCORES	S K AO R Z
SCOUT	S K AW T
SCOUTS	S K AW T S
SCRATCH	S K R AE CH
SCREAM	S K R IY M
SCREAMING	S K R IY M IH NG
SCREEN	S K R IY N
SCREENING	S K R IY N IH NG
SCREW	S K R UW
SCREWED	S K R UW D
SE	S AW TH IY S T
SE(2)	S EY
SE(3)	EH S IY
SEA	S IY
SEAFOOD	S IY F UW D
SEAL	S IY L
SEARCH	S ER CH
SEARS	S IH R Z
SEASON	S IY Z AH N
SEASONS	S IY Z AH N Z
SEAT	S IY T
SEATS	S IY T S
SEATTLE	S IY AE T AH L
SECOND	S EH K AH N D
SECOND(2)	S EH K AH N
SECONDS	S EH K AH N D Z
SECONDS(2)	S EH K AH N Z
SECRET	S IY K R AH T
SECRET(2)	S IY K R IH T
SECRETARIES	S EH K R AH T EH R IY Z
SECRETARY	S EH K R AH T EH R IY
SECTION	S EH K SH AH N
SECTIONS	S EH K SH AH N Z
SECTOR	S EH K T ER
SECURE	S IH K Y UH R
SECURITY	S IH K Y UH R AH T IY
SEE	S IY
SEED	S IY D
SEEDS	S IY D Z
SEEING	S IY IH NG
SEEK	S IY K
SEEM	S IY M
SEEMED	S IY M D
SEEMS	S IY M Z
SEEN	S IY N
SEES	S IY Z
SELDOM	S EH L D AH M
SELECT	S AH L EH K T
SELECTED	S AH L EH K T AH D
SELECTED(2)	S AH L EH K T IH D
SELECTING	S AH L EH K T IH NG
SELECTION	S AH L EH K SH AH N
SELECTIVE	S AH L EH K T IH V
SELF	S EH L F
SELFISH	S EH L F IH SH
SELL	S EH L
SELLING	S EH L IH NG
SELLS	S EH L Z
SEMESTER	S AH M EH S T ER
SEMI	S EH M IY
SEMI(2)	S EH M AY
SENATE	S EH N AH T
SENATE(2)	S EH N IH T
SENATOR	S EH N AH T ER
SEND	S EH N D
SENDING	S EH N D IH NG
SENIOR	S IY N Y ER
SENSE	S EH N S
SENT	S EH N T
SENTENCE	S EH N T AH N S
SENTENCED	S EH N T AH N S T
SENTENCES	S EH N T AH N S AH Z
SENTENCES(2)	S EH N T AH N S IH Z
SENTENCING	S EH N T AH N S IH NG
SEPARATE	S EH P ER EY T
SEPARATE(2)	S EH P ER IH T
SEPARATE(3)	S EH P R AH T
SEPARATED	S EH P ER EY T AH D
SEPARATED(2)	S EH P ER EY T IH D
SEPTEMBER	S EH P T EH M B ER
SERIAL	S IH R IY AH L
SERIES	S IH R IY Z
SERIOUS	S IH R IY AH S
SERIOUSLY	S IH R IY AH S L IY
SERVE	S ER V
SERVED	S ER V D
SERVICE	S ER V AH S
SERVICE(2)	S ER V IH S
SERVICES	S ER V AH S AH Z
SERVICES(2)	S ER V IH S IH Z
SERVING	S ER V IH NG
SESAME	S EH S AH M IY
SET	S EH T
SETS	S EH T S
SETTING	S EH T IH NG
SETTLE	S EH T AH L
SETTLED	S EH T AH L D
SETUP	S EH T AH P
SEVEN	S EH V AH N
SEVENTEEN	S EH V AH N T IY N
SEVENTH	S EH V AH N TH
SEVENTIES	S EH V AH N T IY Z
SEVENTIES(2)	S EH V AH N IY Z
SEVENTY	S EH V AH N T IY
SEVENTY(2)	S EH V AH N IY
SEVERAL	S EH V R AH L
SEVERAL(2)	S EH V ER AH L
SEVERE	S AH V IH R
SEVERELY	S AH V IH R L IY
SEW	S OW
SEWING	S OW IH NG
SEX	S EH K S
SHADE	SH EY D
SHALL	SH AE L
SHAME	SH EY M
SHAPE	SH EY P
SHARE	SH EH R
SHARING	SH EH R IH NG
SHARP	SH AA R P
SHE	SH IY
SHE'D	SH IY D
SHE'LL	SH IY L
SHE'S	SH IY Z
SHED	SH EH D
SHEET	SH IY T
SHELF	SH EH L F
SHELL	SH EH L
SHELTER	SH EH L T ER
SHELVES	SH EH L V Z
SHEPHERD	SH EH P ER D
SHERMAN	SH ER M AH N
SHIFT	SH IH F T
SHIFTS	SH IH F T S
SHIP	SH IH P
SHIRT	SH ER T
SHIRTS	SH ER T S
SHOCK	SH AA K
SHOCKED	SH AA K T
SHOE	SH UW
SHOES	SH UW Z
SHOOT	SH UW T
SHOOTING	SH UW T IH NG
SHOOTINGS	SH UW T IH NG Z
SHOP	SH AA P
SHOPPING	SH AA P IH NG
SHOPS	SH AA P S
SHORE	SH AO R
SHORT	SH AO R T
SHORTER	SH AO R T ER
SHORTLY	SH AO R T L IY
SHORTS	SH AO R T S
SHOT	SH AA T
SHOTGUN	SH AA T G AH N
SHOTS	SH AA T S
SHOULD	SH UH D
SHOULDER	SH OW L D ER
SHOULDN'T	SH UH D AH N T
SHOW	SH OW
SHOWED	SH OW D
SHOWER	SH AW ER
SHOWERS	SH AW ER Z
SHOWING	SH OW IH NG
SHOWN	SH OW N
SHOWS	SH OW Z
SHRIMP	SH R IH M P
SHRUBS	SH R AH B Z
SHUT	SH AH T
SHUTTLE	SH AH T AH L
SHY	SH AY
SICK	S IH K
SIDE	S AY D
SIDES	S AY D Z
SIERRA	S IY EH R AH
SIGHT	S AY T
SIGN	S AY N
SIGNAL	S IH G N AH L
SIGNED	S AY N D
SIGNIFICANT	S AH G N IH F IH K AH N T
SIGNIFICANT(2)	S IH G N IH F IH K AH N T
SIGNS	S AY N Z
SILENCE	S AY L AH N S
SILLY	S IH L IY
SILVER	S IH L V ER
SIMILAR	S IH M AH L ER
SIMPLE	S IH M P AH L
SIMPLY	S IH M P L IY
SINCE	S IH N S
SING	S IH NG
SINGER	S IH NG ER
SINGERS	S IH NG ER Z
SINGING	S IH NG IH NG
SINGLE	S IH NG G AH L
SINK	S IH NG K
SIR	S ER
SISTER	S IH S T ER
SISTER'S	S IH S T ER Z
SISTERS	S IH S T ER Z
SIT	S IH T
SITCOMS	S IH T K AA M Z
SITE	S AY T
SITES	S AY T S
SITS	S IH T S
SITTER	S IH T ER
SITTERS	S IH T ER Z
SITTING	S IH T IH NG
SITUATION	S IH CH UW EY SH AH N
SITUATIONS	S IH CH UW EY SH AH N Z
SIX	S IH K S
SIXTEEN	S IH K S T IY N
SIXTEEN(2)	S IH K S T IY N
SIXTH	S IH K S TH
SIXTIES	S IH K S T IY Z
SIXTY	S IH K S T IY
SIZE	S AY Z
SIZED	S AY Z D
SIZES	S AY Z AH Z
SIZES(2)	S AY Z IH Z
SKI	S K IY
SKIED	S K IY D
SKIING	S K IY IH NG
SKILLS	S K IH L Z
SKIN	S K IH N
SKINNY	S K IH N IY
SKIP	S K IH P
SKIRT	S K ER T
SKIRTS	S K ER T S
SKUNK	S K AH NG K
SKY	S K AY
SLAB	S L AE B
SLACKS	S L AE K S
SLAP	S L AE P
SLEEP	S L IY P
SLEEPING	S L IY P IH NG
SLICE	S L AY S
SLICK	S L IH K
SLIDE	S L AY D
SLIGHT	S L AY T
SLIGHTLY	S L AY T L IY
SLIP	S L IH P
SLOW	S L OW
SLOWLY	S L OW L IY
SMALL	S M AO L
SMALLER	S M AO L ER
SMART	S M AA R T
SMARTER	S M AA R T ER
SMELL	S M EH L
SMITH	S M IH TH
SMOG	S M AA G
SMOKE	S M OW K
SMOKERS	S M OW K ER Z
SMOKING	S M OW K IH NG
SMOOTH	S M UW DH
SNAKE	S N EY K
SNOW	S N OW
SNOWED	S N OW D
SNOWING	S N OW IH NG
SO	S OW
SOAK	S OW K
SOAP	S OW P
SOCCER	S AA K ER
SOCIAL	S OW SH AH L
SOCIALIZED	S OW SH AH L AY Z D
SOCIALLY	S OW SH AH L IY
SOCIETY	S AH S AY AH T IY
SODA	S OW D AH
SOFT	S AA F T
SOFT(2)	S AO F T
SOFTBALL	S AO F T B AO L
SOFTBALL(2)	S AO F B AO L
SOFTWARE	S AO F T W EH R
SOFTWARE(2)	S AO F W EH R
SOIL	S OY L
SOLAR	S OW L ER
SOLD	S OW L D
SOLID	S AA L AH D
SOLUTION	S AH L UW SH AH N
SOLUTIONS	S AH L UW SH AH N Z
SOLVE	S AA L V
SOLVED	S AA L V D
SOME	S AH M
SOMEBODY	S AH M B AA D IY
SOMEBODY(2)	S AH M B AH D IY
SOMEBODY'S	S AH M B AA D IY
SOMEBODY'S(2)	S AH M B AH D IY
SOMEDAY	S AH M D EY
SOMEHOW	S AH M HH AW
SOMEONE	S AH M W AH N
SOMEONE'S	S AH M W AH N Z
SOMEPLACE	S AH M P L EY S
SOMETHING	S AH M TH IH NG
SOMETHING'S	S AH M TH IH NG Z
SOMETIME	S AH M T AY M
SOMETIMES	S AH M T AY M Z
SOMETIMES(2)	S AH M T AY M Z
SOMEWHAT	S AH M W AH T
SOMEWHAT(2)	S AH M HH W AH T
SOMEWHERE	S AH M W EH R
SOMEWHERE(2)	S AH M HH W EH R
SON	S AH N
SON'S	S AH N Z
SONG	S AO NG
SONGS	S AO NG Z
SONS	S AH N Z
SOON	S UW N
SOONER	S UW N ER
SOPHISTICATED	S AH F IH S T AH K EY T IH D
SOPHISTICATED(2)	S AH F IH S T IH K EY T AH D
SOPHOMORE	S AA F M AO R
SORE	S AO R
SORRY	S AA R IY
SORT	S AO R T
SORTING	S AO R T IH NG
SORTS	S AO R T S
SOUND	S AW N D
SOUNDED	S AW N D AH D
SOUNDED(2)	S AW N D IH D
SOUNDS	S AW N D Z
SOUNDS(2)	S AW N Z
SOUP	S UW P
SOURCE	S AO R S
SOURCES	S AO R S AH Z
SOUTH	S AW TH
SOUTHEAST	S AW TH IY S T
SOUTHERN	S AH DH ER N
SOUTHWEST	S AW TH W EH S T
SOVIET	S OW V IY AH T
SOVIET(2)	S OW V IY EH T
SOX	S AA K S
SPACE	S P EY S
SPAGHETTI	S P AH G EH T IY
SPAN	S P AE N
SPANISH	S P AE N IH SH
SPARE	S P EH R
SPEAK	S P IY K
SPEAKER	S P IY K ER
SPEAKING	S P IY K IH NG
SPECIAL	S P EH SH AH L
SPECIALIZED	S P EH SH AH L AY Z D
SPECIALTY	S P EH SH AH L T IY
SPECIALTY(2)	S P EY SH AH L T IY
SPECIFIC	S P AH S IH F IH K
SPECIFIC(2)	S P IH S IH F IH K
SPECIFICALLY	S P AH S IH F IH K L IY
SPEECH	S P IY CH
SPEED	S P IY D
SPELL	S P EH L
SPEND	S P EH N D
SPENDING	S P EH N D IH NG
SPENDS	S P EH N D Z
SPENDS(2)	S P EH N Z
SPENT	S P EH N T
SPICY	S P AY S IY
SPINACH	S P IH N AH CH
SPIRIT	S P IH R AH T
SPIRIT(2)	S P IH R IH T
SPLIT	S P L IH T
SPOILED	S P OY L D
SPOKE	S P OW K
SPONSORED	S P AA N S ER D
SPORT	S P AO R T
SPORTING	S P AO R T IH NG
SPORTS	S P AO R T S
SPORTY	S P AO R T IY
SPOT	S P AA T
SPOTS	S P AA T S
SPRAY	S P R EY
SPREAD	S P R EH D
SPRING	S P R IH NG
SPRING(2)	S P ER IH NG
SPRINGS	S P R IH NG Z
SPRINGS(2)	S P ER IH NG Z
SPRINKLER	S P R IH NG K L ER
SPRINKLER(2)	S P R IH NG K AH L ER
SQUARE	S K W EH R
SQUASH	S K W AA SH
ST	S T R IY T
ST(2)	S EY N T
STABLE	S T EY B AH L
STACK	S T AE K
STADIUM	S T EY D IY AH M
STAFF	S T AE F
STAGE	S T EY JH
STAIRS	S T EH R Z
STAND	S T AE N D
STANDARD	S T AE N D ER D
STANDARDS	S T AE N D ER D Z
STANDING	S T AE N D IH NG
STANDPOINT	S T AE N D P OY N T
STANDS	S T AE N D Z
STAR	S T AA R
STARS	S T AA R Z
START	S T AA R T
STARTED	S T AA R T AH D
STARTED(2)	S T AA R T IH D
STARTER	S T AA R T ER
STARTING	S T AA R T IH NG
STARTS	S T AA R T S
STATE	S T EY T
STATEMENT	S T EY T M AH N T
STATEMENTS	S T EY T M AH N T S
STATES	S T EY T S
STATION	S T EY SH AH N
STATIONARY	S T EY SH AH N EH R IY
STATIONED	S T EY SH AH N D
STATIONS	S T EY SH AH N Z
STATISTICS	S T AH T IH S T IH K S
STATUS	S T AE T AH S
STATUS(2)	S T EY T AH S
STAY	S T EY
STAYED	S T EY D
STAYING	S T EY IH NG
STAYS	S T EY Z
STEADY	S T EH D IY
STEAK	S T EY K
STEAKS	S T EY K S
STEAL	S T IY L
STEALING	S T IY L IH NG
STEAM	S T IY M
STEEL	S T IY L
STEP	S T EH P
STEPHEN	S T IY V AH N
STEPHEN(2)	S T EH F AH N
STEPS	S T EH P S
STEREO	S T EH R IY OW
STEVE	S T IY V
STICK	S T IH K
STICKER	S T IH K ER
STICKING	S T IH K IH NG
STICKS	S T IH K S
STILL	S T IH L
STIR	S T ER
STITCH	S T IH CH
STITCHING	S T IH CH IH NG
STOCK	S T AA K
STOLE	S T OW L
STOLEN	S T OW L AH N
STOMACH	S T AH M AH K
STONE	S T OW N
STOOD	S T UH D
STOP	S T AA P
STOPPED	S T AA P T
STOPPING	S T AA P IH NG
STORE	S T AO R
STORES	S T AO R Z
STORIES	S T AO R IY Z
STORM	S T AO R M
STORMS	S T AO R M Z
STORY	S T AO R IY
STOVE	S T OW V
STRAIGHT	S T R EY T
STRANGE	S T R EY N JH
STRAWBERRIES	S T R AO B EH R IY Z
STREAM	S T R IY M
STREAMS	S T R IY M Z
STREET	S T R IY T
STREETS	S T R IY T S
STRENGTH	S T R EH NG K TH
STRENGTH(2)	S T R EH NG TH
STRESS	S T R EH S
STRETCH	S T R EH CH
STRICT	S T R IH K T
STRICTLY	S T R IH K T L IY
STRIKE	S T R AY K
STRIKES	S T R AY K S
STRING	S T R IH NG
STRIP	S T R IH P
STROKE	S T R OW K
STRONG	S T R AO NG
STRONGER	S T R AO NG ER
STRONGER(2)	S T R AO NG G ER
STRONGLY	S T R AO NG L IY
STRUCTURE	S T R AH K CH ER
STRUGGLE	S T R AH G AH L
STRUGGLING	S T R AH G AH L IH NG
STRUGGLING(2)	S T R AH G L IH NG
STUCK	S T AH K
STUDENT	S T UW D AH N T
STUDENTS	S T UW D AH N T S
STUDIED	S T AH D IY D
STUDIES	S T AH D IY Z
STUDY	S T AH D IY
STUDYING	S T AH D IY IH NG
STUFF	S T AH F
STUPID	S T UW P AH D
STUPID(2)	S T UW P IH D
STYLE	S T AY L
STYLES	S T AY L Z
STYROFOAM	S T AY R AH F OW M
SUBDIVISION	S AH B D IH V IH ZH AH N
SUBJECT	S AH B JH EH K T
SUBJECT(2)	S AH B JH IH K T
SUBJECTS	S AH B JH IH K T S
SUBJECTS(2)	S AH B JH EH K T S
SUBJECTS(3)	S AH B JH EH K S
SUBSCRIBE	S AH B S K R AY B
SUBSCRIPTION	S AH B S K R IH P SH AH N
SUBSTANCE	S AH B S T AH N S
SUBSTANTIAL	S AH B S T AE N CH AH L
SUBSTANTIAL(2)	S AH B S T AE N SH AH L
SUBSTITUTE	S AH B S T AH T UW T
SUBURB	S AH B ER B
SUBURBAN	S AH B ER B AH N
SUBURBS	S AH B ER B Z
SUBWAY	S AH B W EY
SUCCESS	S AH K S EH S
SUCCESSFUL	S AH K S EH S F AH L
SUCH	S AH CH
SUDDEN	S AH D AH N
SUDDENLY	S AH D AH N L IY
SUE	S UW
SUFFER	S AH F ER
SUFFERING	S AH F ER IH NG
SUFFERING(2)	S AH F R IH NG
SUFFICIENT	S AH F IH SH AH N T
SUGAR	SH UH G ER
SUGGEST	S AH G JH EH S T
SUGGESTED	S AH G JH EH S T AH D
SUGGESTED(2)	S AH G JH EH S T IH D
SUING	S UW IH NG
SUIT	S UW T
SUITS	S UW T S
SUMMER	S AH M ER
SUMMERS	S AH M ER Z
SUMMERTIME	S AH M ER T AY M
SUN	S AH N
SUNDAY	S AH N D EY
SUNDAY(2)	S AH N D IY
SUNDAYS	S AH N D EY Z
SUNDAYS(2)	S AH N D IY Z
SUNNY	S AH N IY
SUPER	S UW P ER
SUPERVISION	S UW P ER V IH ZH AH N
SUPERVISOR	S UW P ER V AY Z ER
SUPPER	S AH P ER
SUPPLIES	S AH P L AY Z
SUPPLY	S AH P L AY
SUPPORT	S AH P AO R T
SUPPORTED	S AH P AO R T AH D
SUPPORTED(2)	S AH P AO R T IH D
SUPPORTING	S AH P AO R T IH NG
SUPPOSE	S AH P OW Z
SUPPOSED	S AH P OW Z D
SUPPOSEDLY	S AH P OW Z AH D L IY
SUPREME	S AH P R IY M
SUPREME(2)	S ER P R IY M
SURE	SH UH R
SURELY	SH UH R L IY
SURGERY	S ER JH ER IY
SURPRISE	S ER P R AY Z
SURPRISE(2)	S AH P R AY Z
SURPRISED	S ER P R AY Z D
SURPRISED(2)	S AH P R AY Z D
SURPRISES	S ER P R AY Z IH Z
SURPRISES(2)	S AH P R AY Z IH Z
SURPRISING	S ER P R AY Z IH NG
SURPRISING(2)	S AH P R AY Z IH NG
SURPRISINGLY	S ER P R AY Z IH NG L IY
SURPRISINGLY(2)	S AH P R AY Z IH NG L IY
SURROUNDED	S ER AW N D AH D
SURROUNDED(2)	S ER AW N D IH D
SURVEY	S ER V EY
SURVEY(2)	S ER V EY
SURVIVAL	S ER V AY V AH L
SURVIVE	S ER V AY V
SUSPECT	S AH S P EH K T
SUSPECT(2)	S AH S P EH K T
SUSPENSE	S AH S P EH N S
SUSPENSEFUL	S AH S P EH N S F AH L
SWEAR	S W EH R
SWEAT	S W EH T
SWEATER	S W EH T ER
SWEATERS	S W EH T ER Z
SWEET	S W IY T
SWIM	S W IH M
SWIMMING	S W IH M IH NG
SWING	S W IH NG
SWITCH	S W IH CH
SWITCHBOARD	S W IH CH B AO R D
SWITCHED	S W IH CH T
SYMPHONY	S IH M F AH N IY
SYSTEM	S IH S T AH M
SYSTEMS	S IH S T AH M Z
T.	T IY
TABLE	T EY B AH L
TABLES	T EY B AH L Z
TACO	T AA K OW
TAIL	T EY L
TAKE	T EY K
TAKEN	T EY K AH N
TAKES	T EY K S
TAKING	T EY K IH NG
TALENT	T AE L AH N T
TALENTED	T AE L AH N T AH D
TALENTED(2)	T AE L AH N T IH D
TALK	T AO K
TALKED	T AO K T
TALKING	T AO K IH NG
TALKS	T AO K S
TALL	T AO L
TANK	T AE NG K
TAPE	T EY P
TAPES	T EY P S
TARGET	T AA R G AH T
TARGET(2)	T ER G AH T
TARPLEY	T AA R P L IY
TASK	T AE S K
TASTE	T EY S T
TASTES	T EY S T S
TAUGHT	T AO T
TAURUS	T AO R AH S
TAX	T AE K S
TAXED	T AE K S T
TAXES	T AE K S AH Z
TAXES(2)	T AE K S IH Z
TAXING	T AE K S IH NG
TAXPAYERS	T AE K S P EY ER Z
TEA	T IY
TEACH	T IY CH
TEACHER	T IY CH ER
TEACHERS	T IY CH ER Z
TEACHES	T IY CH AH Z
TEACHES(2)	T IY CH IH Z
TEACHING	T IY CH IH NG
TEAM	T IY M
TEAMS	T IY M Z
TEAR	T EH R
TEAR(2)	T IH R
TECH	T EH K
TECHNICAL	T EH K N IH K AH L
TECHNICALLY	T EH K N IH K AH L IY
TECHNICALLY(2)	T EH K N IH K L IY
TECHNIQUES	T EH K N IY K S
TECHNOLOGY	T EH K N AA L AH JH IY
TEE	T IY
TEENAGE	T IY N EY JH
TEENAGER	T IY N EY JH ER
TEENAGERS	T IY N EY JH ER Z
TEETH	T IY TH
TELEPHONE	T EH L AH F OW N
TELEVISION	T EH L AH V IH ZH AH N
TELL	T EH L
TELLER	T EH L ER
TELLING	T EH L IH NG
TELLS	T EH L Z
TEMPERATURE	T EH M P R AH CH ER
TEMPERATURE(2)	T EH M P ER AH CH ER
TEMPERATURES	T EH M P R AH CH ER Z
TEMPERATURES(2)	T EH M P ER AH CH ER Z
TEMPORARY	T EH M P ER EH R IY
TEN	T EH N
TEND	T EH N D
TENDED	T EH N D AH D
TENDED(2)	T EH N D IH D
TENDENCY	T EH N D AH N S IY
TENDS	T EH N D Z
TENNESSEE	T EH N AH S IY
TENNIS	T EH N AH S
TENNIS(2)	T EH N IH S
TENT	T EH N T
TENTH	T EH N TH
TENTS	T EH N T S
TERM	T ER M
TERMINAL	T ER M AH N AH L
TERMS	T ER M Z
TERRIBLE	T EH R AH B AH L
TERRIBLY	T EH R AH B L IY
TERRIFIC	T ER IH F IH K
TERRITORY	T EH R IH T AO R IY
TEST	T EH S T
TESTED	T EH S T AH D
TESTED(2)	T EH S T IH D
TESTING	T EH S T IH NG
TESTS	T EH S T S
TEX	T EH K S
TEXAN	T EH K S AH N
TEXANS	T EH K S AH N Z
TEXAS	T EH K S AH S
TEXOMA	T EH G Z OW M AH
THAN	DH AE N
THAN(2)	DH AH N
THANK	TH AE NG K
THANKS	TH AE NG K S
THANKSGIVING	TH AE NG K S G IH V IH NG
THAT	DH AE T
THAT(2)	DH AH T
THAT'D	DH AE T IH D
THAT'LL	DH AE T AH L
THAT'S	DH AE T S
THE	DH AH
THE(2)	DH AH
THE(3)	DH IY
THEATER	TH IY AH T ER
THEATERS	TH IY AH T ER Z
THEATRE	TH IY AH T ER
THEFT	TH EH F T
THEIR	DH EH R
THEIRS	DH EH R Z
THEM	DH EH M
THEM(2)	DH AH M
THEM'S	DH EH M Z
THEME	TH IY M
THEMSELVES	DH EH M S EH L V Z
THEMSELVES(2)	DH AH M S EH L V Z
THEN	DH EH N
THEORY	TH IH R IY
THEORY(2)	TH IY ER IY
THERE	DH EH R
THERE'D	DH EH R D
THERE'LL	DH EH R AH L
THERE'RE	DH EH R ER
THERE'S	DH EH R Z
THEREFORE	DH EH R F AO R
THESE	DH IY Z
THEY	DH EY
THEY'D	DH EY D
THEY'LL	DH EY L
THEY'RE	DH EH R
THEY'VE	DH EY V
THICK	TH IH K
THIN	TH IH N
THING	TH IH NG
THINGS	TH IH NG Z
THINK	TH IH NG K
THINK'S	TH IH NG K S
THINKING	TH IH NG K IH NG
THINKS	TH IH NG K S
THIRD	TH ER D
THIRTEEN	TH ER T IY N
THIRTIES	TH ER T IY Z
THIRTY	TH ER D IY
THIRTY(2)	TH ER T IY
THIS	DH IH S
THIS(2)	DH IH S
THOMAS	T AA M AH S
THOROUGHLY	TH ER OW L IY
THOSE	DH OW Z
THOUGH	DH OW
THOUGHT	TH AO T
THOUGHTS	TH AO T S
THOUSAND	TH AW Z AH N D
THOUSAND(2)	TH AW Z AH N
THOUSANDS	TH AW Z AH N D Z
THOUSANDS(2)	TH AW Z AH N Z
THREAT	TH R EH T
THREATENED	TH R EH T AH N D
THREATENING	TH R EH T AH N IH NG
THREATENING(2)	TH R EH T N IH NG
THREE	TH R IY
THREW	TH R UW
THRILLED	TH R IH L D
THROAT	TH R OW T
THROUGH	TH R UW
THROUGHOUT	TH R UW AW T
THROW	TH R OW
THROWING	TH R OW IH NG
THROWN	TH R OW N
THUMB	TH AH M
THURSDAY	TH ER Z D EY
THURSDAY(2)	TH ER Z D IY
THURSDAYS	TH ER Z D EY Z
THURSDAYS(2)	TH ER Z D IY Z
TICKET	T IH K AH T
TICKET(2)	T IH K IH T
TICKETS	T IH K AH T S
TICKETS(2)	T IH K IH T S
TIE	T AY
TIED	T AY D
TIES	T AY Z
TIGHT	T AY T
TILL	T IH L
TIME	T AY M
TIMES	T AY M Z
TIMING	T AY M IH NG
TIN	T IH N
TINY	T AY N IY
TIP	T IH P
TIPS	T IH P S
TIRE	T AY ER
TIRED	T AY ER D
TIRES	T AY ER Z
TITLE	T AY T AH L
TO	T UW
TO(2)	T IH
TO(3)	T AH
TODAY	T AH D EY
TODAY(2)	T UW D EY
TODAY'S	T AH D EY Z
TODAY'S(2)	T UW D EY Z
TOGETHER	T AH G EH DH ER
TOILET	T OY L AH T
TOKEN	T OW K AH N
TOLD	T OW L D
TOLERATE	T AA L ER EY T
TOM	T AA M
TOMATO	T AH M EY T OW
TOMATO(2)	T AH M AA T OW
TOMATOES	T AH M EY T OW Z
TOMATOES(2)	T AH M AA T OW Z
TOMORROW	T AH M AA R OW
TOMORROW(2)	T UW M AA R OW
TON	T AH N
TONE	T OW N
TONIGHT	T AH N AY T
TONIGHT(2)	T UW N AY T
TONS	T AH N Z
TOO	T UW
TOOK	T UH K
TOOL	T UW L
TOOLS	T UW L Z
TOOTH	T UW TH
TOP	T AA P
TOP(2)	T AO P
TOPIC	T AA P IH K
TOPICS	T AA P IH K S
TOPS	T AA P S
TORN	T AO R N
TORNADO	T AO R N EY D OW
TOTAL	T OW T AH L
TOTALLY	T OW T AH L IY
TOUCH	T AH CH
TOUCHED	T AH CH T
TOUGH	T AH F
TOUGHER	T AH F ER
TOUR	T UH R
TOURNAMENT	T UH R N AH M AH N T
TOURNAMENTS	T ER N AH M AH N T S
TOWARD	T AH W AO R D
TOWARD(2)	T AO R D
TOWARDS	T AH W AO R D Z
TOWARDS(2)	T AO R D Z
TOWN	T AW N
TOWNS	T AW N Z
TOY	T OY
TOYOTA	T OW Y OW T AH
TOYS	T OY Z
TRACK	T R AE K
TRACKS	T R AE K S
TRADE	T R EY D
TRADED	T R EY D IH D
TRADING	T R EY D IH NG
TRADITION	T R AH D IH SH AH N
TRADITIONAL	T R AH D IH SH AH N AH L
TRAFFIC	T R AE F IH K
TRAIL	T R EY L
TRAILER	T R EY L ER
TRAIN	T R EY N
TRAINED	T R EY N D
TRAINING	T R EY N IH NG
TRANSFER	T R AE N S F ER
TRANSFER(2)	T R AE N S F ER
TRANSFERRED	T R AE N S F ER D
TRANSFERRED(2)	T R AE N S F ER D
TRANSIT	T R AE N Z AH T
TRANSITION	T R AE N Z IH SH AH N
TRANSMISSION	T R AE N S M IH SH AH N
TRANSMISSION(2)	T R AE N Z M IH SH AH N
TRANSPORTATION	T R AE N S P ER T EY SH AH N
TRAP	T R AE P
TRASH	T R AE SH
TRAVEL	T R AE V AH L
TRAVELED	T R AE V AH L D
TRAVELING	T R AE V AH L IH NG
TRAVELING(2)	T R AE V L IH NG
TREAT	T R IY T
TREATED	T R IY T AH D
TREATED(2)	T R IY T IH D
TREATMENT	T R IY T M AH N T
TREE	T R IY
TREES	T R IY Z
TREK	T R EH K
TREMENDOUS	T R AH M EH N D AH S
TREMENDOUS(2)	T R IH M EH N D AH S
TREMENDOUSLY	T R AH M EH N D AH S L IY
TREMENDOUSLY(2)	T R IH M EH N D AH S L IY
TREND	T R EH N D
TRENDS	T R EH N D Z
TRENDS(2)	T R EH N Z
TRIAL	T R AY AH L
TRIAL(2)	T R AY L
TRIALS	T R AY AH L Z
TRIALS(2)	T R AY L Z
TRICK	T R IH K
TRIED	T R AY D
TRIES	T R AY Z
TRIM	T R IH M
TRIP	T R IH P
TRIPS	T R IH P S
TROOPS	T R UW P S
TROUBLE	T R AH B AH L
TROUT	T R AW T
TRUCK	T R AH K
TRUCKS	T R AH K S
TRUE	T R UW
TRULY	T R UW L IY
TRUMPET	T R AH M P AH T
TRUNK	T R AH NG K
TRUST	T R AH S T
TRUTH	T R UW TH
TRY	T R AY
TRYING	T R AY IH NG
TRYING(2)	T R AY NG
TUB	T AH B
TUBE	T UW B
TUBE(2)	T Y UW B
TUBES	T UW B Z
TUESDAY	T UW Z D IY
TUESDAY(2)	T UW Z D EY
TUESDAY(3)	T Y UW Z D EY
TUITION	T Y UW IH SH AH N
TUNA	T UW N AH
TUNA(2)	T Y UW N AH
TUNE	T UW N
TUNED	T UW N D
TURKEY	T ER K IY
TURN	T ER N
TURNED	T ER N D
TURNING	T ER N IH NG
TURNS	T ER N Z
TURTLE	T ER T AH L
TURTLES	T ER T AH L Z
TWELVE	T W EH L V
TWENTIES	T W EH N T IY Z
TWENTIES(2)	T W EH N IY Z
TWENTY	T W EH N T IY
TWENTY(2)	T W EH N IY
TWICE	T W AY S
TWIN	T W IH N
TWINS	T W IH N Z
TWIST	T W IH S T
TWO	T UW
TYLER	T AY L ER
TYPE	T AY P
TYPES	T AY P S
TYPEWRITER	T AY P R AY T ER
TYPICAL	T IH P AH K AH L
TYPICAL(2)	T IH P IH K AH L
TYPICALLY	T IH P IH K L IY
TYPICALLY(2)	T IH P IH K AH L IY
U.	Y UW
UGLY	AH G L IY
ULTIMATE	AH L T AH M AH T
ULTIMATELY	AH L T AH M AH T L IY
UNANIMOUS	Y UW N AE N AH M AH S
UNBELIEVABLE	AH N B AH L IY V AH B AH L
UNCLE	AH NG K AH L
UNCLES	AH NG K AH L Z
UNCOMFORTABLE	AH N K AH M F ER T AH B AH L
UNDER	AH N D ER
UNDERGRADUATE	AH N D ER G R AE JH AH W AH T
UNDERNEATH	AH N D ER N IY TH
UNDERSTAND	AH N D ER S T AE N D
UNDERSTANDING	AH N D ER S T AE N D IH NG
UNDERSTOOD	AH N D ER S T UH D
UNEMPLOYED	AH N EH M P L OY D
UNEMPLOYMENT	AH N IH M P L OY M AH N T
UNEXPECTED	AH N IH K S P EH K T IH D
UNFAIR	AH N F EH R
UNFAIR(2)	AH N F EH R
UNFAIR(3)	AO N F EH R
UNFORTUNATE	AH N F AO R CH AH N AH T
UNFORTUNATE(2)	AH N F AO R CH UW N AH T
UNFORTUNATELY	AH N F AO R CH AH N AH T L IY
UNFORTUNATELY(2)	AH N F AO R CH UW N AH T L IY
UNHAPPY	AH N HH AE P IY
UNIFORM	Y UW N AH F AO R M
UNION	Y UW N Y AH N
UNIONS	Y UW N Y AH N Z
UNIQUE	Y UW N IY K
UNIT	Y UW N AH T
UNIT(2)	Y UW N IH T
UNITED	Y UW N AY T AH D
UNITED(2)	Y UW N AY T IH D
UNITS	Y UW N AH T S
UNITS(2)	Y UW N IH T S
UNIVERSAL	Y UW N AH V ER S AH L
UNIVERSITIES	Y UW N AH V ER S AH T IY Z
UNIVERSITY	Y UW N AH V ER S AH T IY
UNLESS	AH N L EH S
UNQUOTE	AH N K W OW T
UNREAL	AH N R IY L
UNTIL	AH N T IH L
UNUSUAL	AH N Y UW ZH AH W AH L
UNUSUAL(2)	AH N Y UW ZH UW AH L
UNUSUAL(3)	AH N Y UW ZH W AH L
UP	AH P
UPON	AH P AA N
UPPER	AH P ER
UPS	AH P S
UPSET	AH P S EH T
UPSET(2)	AH P S EH T
UPSTAIRS	AH P S T EH R Z
UPSTATE	AH P S T EY T
URBAN	ER B AH N
URINE	Y ER AH N
URINE(2)	Y UH R AH N
US	AH S
US(2)	Y UW EH S
USE	Y UW S
USE(2)	Y UW Z
USED	Y UW Z D
USEFUL	Y UW S F AH L
USELESS	Y UW S L AH S
USER	Y UW Z ER
USERS	Y UW Z ER Z
USES	Y UW S AH Z
USES(2)	Y UW S IH Z
USES(3)	Y UW Z AH Z
USES(4)	Y UW Z IH Z
USING	Y UW Z IH NG
USUAL	Y UW ZH AH W AH L
USUAL(2)	Y UW ZH UW AH L
USUALLY	Y UW ZH AH W AH L IY
USUALLY(2)	Y UW ZH AH L IY
UTAH	Y UW T AO
UTILITIES	Y UW T IH L AH T IY Z
V.	V IY
VACATION	V EY K EY SH AH N
VACATIONS	V EY K EY SH AH N Z
VACUUM	V AE K Y UW M
VALLEY	V AE L IY
VALUABLE	V AE L Y AH B AH L
VALUABLE(2)	V AE L Y UW B AH L
VALUE	V AE L Y UW
VALUES	V AE L Y UW Z
VAN	V AE N
VANS	V AE N Z
VARIES	V EH R IY Z
VARIETY	V ER AY AH T IY
VARIOUS	V EH R IY AH S
VARY	V EH R IY
VEGAS	V EY G AH S
VEGETABLE	V EH JH T AH B AH L
VEGETABLES	V EH JH T AH B AH L Z
VEGETARIAN	V EH JH AH T EH R IY AH N
VEHICLE	V IY HH IH K AH L
VEHICLE(2)	V IY IH K AH L
VEHICLES	V IY HH IH K AH L Z
VEHICLES(2)	V IY IH K AH L Z
VERDICT	V ER D IH K T
VERMONT	V ER M AA N T
VERSION	V ER ZH AH N
VERSUS	V ER S AH S
VERSUS(2)	V ER S AH Z
VERY	V EH R IY
VET	V EH T
VICE	V AY S
VICIOUS	V IH SH AH S
VICTIM	V IH K T AH M
VICTIM(2)	V IH K T IH M
VICTIMS	V IH K T AH M Z
VICTIMS(2)	V IH K T IH M Z
VIDEO	V IH D IY OW
VIDEOS	V IH D IY OW Z
VIETNAM	V IY EH T N AA M
VIETNAMESE	V IY EH T N AA M IY S
VIEW	V Y UW
VIEWPOINT	V Y UW P OY N T
VIEWS	V Y UW Z
VILLAGE	V IH L AH JH
VILLAGE(2)	V IH L IH JH
VIOLENCE	V AY AH L AH N S
VIOLENT	V AY AH L AH N T
VIOLENT(2)	V AY L AH N T
VIRGINIA	V ER JH IH N Y AH
VIRTUALLY	V ER CH UW AH L IY
VIRTUALLY(2)	V ER CH UW L IY
VISA	V IY Z AH
VISION	V IH ZH AH N
VISIT	V IH Z AH T
VISIT(2)	V IH Z IH T
VISITED	V IH Z AH T AH D
VISITED(2)	V IH Z IH T IH D
VISITING	V IH Z AH T IH NG
VISITING(2)	V IH Z IH T IH NG
VITAMINS	V AY T AH M AH N Z
VOICE	V OY S
VOLLEYBALL	V AA L IY B AO L
VOLUME	V AA L Y UW M
VOLUNTARY	V AA L AH N T EH R IY
VOLUNTEER	V AA L AH N T IH R
VOLVO	V OW L V OW
VOTE	V OW T
VOTED	V OW T AH D
VOTED(2)	V OW T IH D
VOTER	V OW T ER
VOTERS	V OW T ER Z
VOTES	V OW T S
VOTING	V OW T IH NG
W.	D AH B AH L Y UW
WACO	W EY K OW
WAGE	W EY JH
WAGES	W EY JH AH Z
WAGES(2)	W EY JH IH Z
WAGON	W AE G AH N
WAIT	W EY T
WAITED	W EY T AH D
WAITED(2)	W EY T IH D
WAITING	W EY T IH NG
WAKE	W EY K
WAL	W AO L
WALK	W AO K
WALK(2)	W AA K
WALKED	W AO K T
WALKING	W AO K IH NG
WALKS	W AO K S
WALL	W AO L
WALLPAPER	W AO L P EY P ER
WALLS	W AO L Z
WANT	W AA N T
WANT(2)	W AO N T
WANTED	W AA N T AH D
WANTED(2)	W AO N T IH D
WANTED(3)	W AO N IH D
WANTING	W AA N T IH NG
WANTING(2)	W AA N IH NG
WANTS	W AA N T S
WANTS(2)	W AO N T S
WAR	W AO R
WARDROBE	W AO R D R OW B
WAREHOUSE	W EH R HH AW S
WARM	W AO R M
WARMER	W AO R M ER
WARRANTY	W AO R AH N T IY
WARS	W AO R Z
WAS	W AA Z
WAS(2)	W AH Z
WAS(3)	W AH Z
WAS(4)	W AO Z
WASH	W AA SH
WASH(2)	W AO SH
WASHER	W AA SH ER
WASHING	W AA SH IH NG
WASHINGTON	W AA SH IH NG T AH N
WASHINGTON(2)	W AO SH IH NG T AH N
WASN'T	W AA Z AH N T
WASN'T(2)	W AH Z AH N T
WASTE	W EY S T
WASTED	W EY S T AH D
WASTED(2)	W EY S T IH D
WASTING	W EY S T IH NG
WATCH	W AA CH
WATCH(2)	W AO CH
WATCHED	W AA CH T
WATCHED(2)	W AO CH T
WATCHES	W AA CH AH Z
WATCHES(2)	W AA CH IH Z
WATCHING	W AA CH IH NG
WATER	W AO T ER
WATERING	W AO T ER IH NG
WAVE	W EY V
WAY	W EY
WAYS	W EY Z
WE	W IY
WE'D	W IY D
WE'LL	W IY L
WE'LL(2)	W IH L
WE'RE	W IY R
WE'RE(2)	W IH R
WE'RE(3)	W ER
WE'VE	W IY V
WEAK	W IY K
WEALTHY	W EH L TH IY
WEAPON	W EH P AH N
WEAPONS	W EH P AH N Z
WEAR	W EH R
WEARING	W EH R IH NG
WEARS	W EH R Z
WEATHER	W EH DH ER
WEATHER'S	W EH DH ER Z
WEDDING	W EH D IH NG
WEDNESDAY	W EH N Z D IY
WEDNESDAY(2)	W EH N Z D EY
WEED	W IY D
WEEDS	W IY D Z
WEEK	W IY K
WEEKEND	W IY K EH N D
WEEKEND(2)	W IY K IH N D
WEEKENDS	W IY K EH N D Z
WEEKLY	W IY K L IY
WEEKS	W IY K S
WEIGH	W EY
WEIGHT	W EY T
WEIGHTS	W EY T S
WEIRD	W IH R D
WELCOME	W EH L K AH M
WELFARE	W EH L F EH R
WELL	W EH L
WENT	W EH N T
WERE	W ER
WERE(2)	W ER
WEREN'T	W ER AH N T
WEREN'T(2)	W ER N T
WEST	W EH S T
WESTERN	W EH S T ER N
WESTERN(2)	HH W EH S T ER N
WET	W EH T
WHAT	W AH T
WHAT(2)	HH W AH T
WHAT'S	W AH T S
WHAT'S(2)	HH W AH T S
WHATEVER	W AH T EH V ER
WHATEVER(2)	HH W AH T EH V ER
WHATNOT	W AH T N AA T
WHATNOT(2)	HH W AH T N AA T
WHATSOEVER	W AH T S OW EH V ER
WHATSOEVER(2)	HH W AH T S OW EH V ER
WHEEL	W IY L
WHEEL(2)	HH W IY L
WHEELS	W IY L Z
WHEELS(2)	HH W IY L Z
WHEN	W EH N
WHEN(2)	HH W EH N
WHEN(3)	W IH N
WHEN(4)	HH W IH N
WHENEVER	W EH N EH V ER
WHENEVER(2)	HH W EH N EH V ER
WHERE	W EH R
WHERE(2)	HH W EH R
WHERE'S	W EH R Z
WHERE'S(2)	HH W EH R Z
WHEREAS	W EH R AE Z
WHEREAS(2)	HH W EH R AE Z
WHEREVER	W EH R EH V ER
WHEREVER(2)	HH W EH R EH V ER
WHETHER	W EH DH ER
WHETHER(2)	HH W EH DH ER
WHICH	W IH CH
WHICH(2)	HH W IH CH
WHILE	W AY L
WHILE(2)	HH W AY L
WHITE	W AY T
WHITE(2)	HH W AY T
WHIZ	W IH Z
WHIZ(2)	HH W IH Z
WHO	HH UW
WHO'S	HH UW Z
WHOA	W OW
WHOA(2)	HH W OW
WHOA(3)	HH OW
WHOEVER	HH UW EH V ER
WHOLE	HH OW L
WHOSE	HH UW Z
WHY	W AY
WHY(2)	HH W AY
WIDE	W AY D
WIFE	W AY F
WIFE'S	W AY F S
WILD	W AY L D
WILL	W IH L
WILL(2)	W AH L
WILLIAMS	W IH L Y AH M Z
WILLING	W IH L IH NG
WIN	W IH N
WIND	W AY N D
WIND(2)	W IH N D
WINDOW	W IH N D OW
WINDOWS	W IH N D OW Z
WINDS	W IH N D Z
WINDS(2)	W AY N D Z
WINDY	W IH N D IY
WINDY(2)	W AY N D IY
WINE	W AY N
WINNING	W IH N IH NG
WINS	W IH N Z
WINTER	W IH N T ER
WINTERS	W IH N T ER Z
WINTERTIME	W IH N T ER T AY M
WIPE	W AY P
WIRE	W AY ER
WIRE(2)	W AY R
WISCONSIN	W IH S K AA N S AH N
WISE	W AY Z
WISH	W IH SH
WISHED	W IH SH T
WITH	W IH DH
WITH(2)	W IH TH
WITH(3)	W IH TH
WITH(4)	W IH DH
WITHIN	W IH DH IH N
WITHIN(2)	W IH TH IH N
WITHOUT	W IH TH AW T
WITHOUT(2)	W IH DH AW T
WIVES	W AY V Z
WOK	W AA K
WOKE	W OW K
WOLVES	W UH L V Z
WOMAN	W UH M AH N
WOMAN'S	W UH M AH N Z
WOMEN	W IH M AH N
WOMEN'S	W IH M AH N Z
WON	W AH N
WON(2)	W AA N
WON'T	W OW N T
WONDER	W AH N D ER
WONDERED	W AH N D ER D
WONDERFUL	W AH N D ER F AH L
WONDERING	W AH N D ER IH NG
WOOD	W UH D
WOODEN	W UH D AH N
WOODS	W UH D Z
WOODWORKING	W UH D W ER K IH NG
WOOL	W UH L
WORD	W ER D
WORDPERFECT	W ER D P ER F EH K T
WORDS	W ER D Z
WORE	W AO R
WORK	W ER K
WORKED	W ER K T
WORKER	W ER K ER
WORKERS	W ER K ER Z
WORKING	W ER K IH NG
WORKOUT	W ER K AW T
WORKS	W ER K S
WORLD	W ER L D
WORLD'S	W ER L D Z
WORMS	W ER M Z
WORN	W AO R N
WORRIED	W ER IY D
WORRIES	W ER IY Z
WORRY	W ER IY
WORRYING	W ER IY IH NG
WORSE	W ER S
WORST	W ER S T
WORTH	W ER TH
WORTHWHILE	W ER TH W AY L
WOULD	W UH D
WOULDN'T	W UH D AH N T
WOUND	W AW N D
WOUND(2)	W UW N D
WOW	W AW
WRAP	R AE P
WRAPPED	R AE P T
WRECK	R EH K
WRESTLING	R EH S L IH NG
WRESTLING(2)	R EH S AH L IH NG
WRITE	R AY T
WRITER	R AY T ER
WRITERS	R AY T ER Z
WRITES	R AY T S
WRITING	R AY T IH NG
WRITTEN	R IH T AH N
WRONG	R AO NG
WROTE	R OW T
WYOMING	W AY OW M IH NG
X.	EH K S
X.(2)	AE K S
Y.	W AY
YARD	Y AA R D
YARDS	Y AA R D Z
YEAH	Y AE
YEAR	Y IH R
YEAR'S	Y IH R Z
YEARLY	Y IH R L IY
YEARS	Y IH R Z
YEARS(2)	Y ER Z
YELL	Y EH L
YELLOW	Y EH L OW
YELLOWSTONE	Y EH L OW S T OW N
YEP	Y EH P
YES	Y EH S
YESTERDAY	Y EH S T ER D EY
YESTERDAY(2)	Y EH S T ER D IY
YET	Y EH T
YORK	Y AO R K
YOU	Y UW
YOU'D	Y UW D
YOU'D(2)	Y UH D
YOU'LL	Y UW L
YOU'RE	Y UH R
YOU'RE(2)	Y UW R
YOU'VE	Y UW V
YOUNG	Y AH NG
YOUNGER	Y AH NG G ER
YOUNGEST	Y AH NG G AH S T
YOUR	Y AO R
YOUR(2)	Y UH R
YOURS	Y UH R Z
YOURS(2)	Y AO R Z
YOURS(3)	Y ER Z
YOURSELF	Y ER S EH L F
YOURSELF(2)	Y UH R S EH L F
YOURSELF(3)	Y AO R S EH L F
YOUTH	Y UW TH
Z.	Z IY
ZERO	Z IH R OW
ZERO(2)	Z IY R OW
ZONE	Z OW N
